----------------------------------------------------------------------------------------------------------------------------------------------------------------------------------------------------------------------------------------------------------------------------------------
----------------------------]--------------------------------------------------------------------------------S--------------------------------------------------------------------------------------------------------------------------------------------------------------------------
----------------------------X----------------------------------------------------------------------------------------------------------------S-------------------------------------------------------S--S---------------------------------------------------SSSSSSSSSX------------------
----------------------------------------------------------------------------------------------------------------------------------------------------------------------------------------------------------------------------------------------------------------------------------------
----------------------------------------------------------------------------------------------------------------------------------------------------------------------------------------------------------------------------------------------------------------------------------------
----------------------------------------------S----------SSS------------------------oooo----------------------X------SS-----------------------------------------------E------SSS----------------------------------------------E------------------------------------------------------QQQ
------------------------------------------------------------------------------------------XXXXXXX--------------------------------------------------X-------------------------------------------------------XXX--------------------------------------------------------------------------
----------------------------------------o----------------------------------------------------------XX-----------------------------------------------------------------------------------------------------------------------------------------------------------------------------------
-------------------------------------------SSSS------------------------o------------------------------------oo-----------------oo---------------------------------E--------------------oo---------------------------------E--------------------oo---------------------------------E-----
---QQQ-------E-----------------------SSS--------------------------E----ooo---------X--XXX-----------------E------Q----S---Q----------------X------------------E--<>------QS---S---------oo---------X------------------E--<>------QQ------QQ-----o----------X------------------E--<>--SSS
------E-----<>---E-----------X------------------------------------>------------E---X---------------------<>--------------------------------X-E---------------<>--[]--------------------------------X-----------------<---[]--------------------------------X---------------------[]-----
-----<>-----[]--<>-----------------------------------------------<]----------------X---------------------[]-------------------------------XX-----------------[]--[]-------------------------------XX-----------------[]--[]------------------------------XXX---------------------[]-----
-----[]-----[]--[]-E------------E--------------------E-------E---[]--------E-------X---------------------[]----------EE-E----------------XXXE--E-----------XX[]--[]----------EE-E----------------XXX-----------------[]--[]----------EE-E----------------XXX---------------------[]--E--
XXXXXXXXXXXXXXXXXXXX-----XX-XXXXXXXXXXXXXXXXXXXXXXXXXXXXXXXXXXXXXXXXXX-XXXXXXXXXXXXX---------------XXXXXXXXXX-X-XXXXXXXXXXXXXXXXXXXXXXXXXXXXXX-XX-----XXXXXXXXXXXXXXXXXXXXXXXXXXXXXXXXXXXXXXXXXXXXXX---XX------XXXXXXXXXXXXXXXXXXXXXXXXXXXXXXXXXXXXXXXXXXXXXXXXXXX----XXXXXXXXXXXXXXXXXX
