------------------------------------------------------------------X---------------------------------------------------------------------------------------------------------------------------------------------------------------------------------------------------------------------
-----------------------------------------------------------------------------------------------------------------------------------------S-------------------------------------------------------S-------------------------------------------------------S------------------------------
-------------------------------------------------------------------------------------------------------------------------------------SSSSS-S--------------------------------------------------------------------------------------------------------------------------------------------
----------------------------------------------------------------------------------------------------------------------------------------------------------------------------------------------------------------------------------------------------------------------------------------
--------------------------------------------------------------------------------------------------------------------------------------------E-------------------------------------------------------------------------------------------------------------------------------------------
---------SQ--------------SSS-----------------------------o-----------------------SSS--------------------------------------------------------------------------------------------------------------S-------SQQ-------------------ooo-----------------------E---S---S---------------------
---------------------------------------------------------------XXXXXX-----------------------------------------XX--------------------------------------------------------------XXXXXX--------------------------------------------------XXXXXXX-------------------------------------------
--XX----------X---------------------------------------------------------------------------------------------X-XX------------------------------------------------------------------------------------------------------------------------------------------------------------------------
--XX---------XX-----------------------------oo----------------------------------------------------ooo-------X-------------------------E--------------------oo------------------------------------o-----------------oo------------------------------------o-----------------oo-----------
--XX--------XXX-------------------------------------------XX-----------------<>--SSS----------------------XXX-XX------------------E--<>---S-----------E-----SS-----X---X--X------------------<>-------------QQQQ----------X-------XXX----------------<>------QQ-------------oo---------X
-XXXX------XXXX---------------B----------------------------------------------[]---------------------------XXXXXX---------------------[]--------------->-----------XX---X---------------------[]------------------------------------------------------[]--------------------------------X
-XXXX------XXXX--------------------B-----------------------------------------[]---------------------------X-XXXX---------------------[]--------------[]-----------X----X---------------------[]-------------------------------XX---------------------[]-------------------------------XX
XXXXX----EXXXXXX---E------EE-------b-E---------------EE----------------------[]----------EE-E---------------XXXX---------------------[]----------EE--[]--------E------XX---------------------[]-------------E----------------XXX---------------------[]----------EE-E----------------XXX
XXXXX--XXXXXXXXXXXXXXXXXXXXXXXXXXXXXXXXXXXX-X--XXXXXXXXX-------------XXXXXXXXXXXXXXXXXXXXXXXXXXXXX-XXXXXXXXXXXXX---XX------X-XXXXXXXXXXXXXXXXXXXXXXXXXXX---XXXXXXXXXXXXX--------------XXXXXXXXXXXXXXXXXXXXXXXXXXXXXXXXXXXXX-XXXX-------------XXXXXXXXXXXX---XXXXXXXXXXXXXXXXXXXXXXXXXXXX
