------------------------------------------------------------------------------------------------------------------------------------------------------X---------------------------------------------------------------------------------------------------------------------------------
--------------------X--------------------------------------------------------------------------------------X-S-----------------------------------------------------S---------------------------------------------------------S-------------------------------------------------------S--
---------------------------------------------------------------------------------------------------------------------------------------------------------------------------------------------------------------------------S------------------------------------S---X--------------SSS--
----------------------------------------------------------------------------------------------------------------------------------------------------------------------------------------------------------------------------------------------------------------------------------------
----------------------------------------------------------------------------------------------------------------------------------------------------------------------------------------------------------------------------------------------------------------------------------------
----XXX-------o---------------o-----------------------XX-------------------------------------------------------------SSS---------------------------------------------SSQ-----SS---------------------------------------------------------------------------------------------------------
-o-----------------------------XX-----XXX----------------------------------------------------XXX----------------------------------------------------------------------------------------------------------XXXXX------------------------------------------------------X------------------
XXX----------------------------------------------------------------------------------------------XXX------------------------------------------------------------------------------------------------------------------------------------------------------------------------------------
--------------XXXX----------------------------------oo-----------------oo------------------------------------o----------------oooo----------------------------------------------------ooo---------------------------------E--------------------oo---------------------------------E-----
X-------------X------------X--XXXX----------------E---------------------S----------X----------------------E--------------------------------X-------------------------SSS---------------------------X--XX-----------------<>---------------------oo----------------------------E--<>---S-
----------------E---------XX---------------------<>---------------E----------------X---------------------<>-------------------------------XX----------------------E--------------------------------X---------------------[]----X---------------------------X-----------------<---[]-----
-------------------------XXX---------------------[]--------------<>----------------X---------------------[]------------------------------XXX---------------------<>-------------------------------XX-----------------<>--[]-------------------------------XX----------------X[]--[]-----
-----------X-X----------XXXX------------------E--[]----------EE--[]---------------XX---------------------[]-----------E-E----------------XXX---------------------[]-----------E-EE---------------XXX-----------------[]--[]----------EE-EE---------------XXX-----------------[]--[]-----
-----XXXXXXXXX--XXXXXXXXXXXXXXX---------XXXXXXXXXXXXXXXXXXXXXXXXXXXXXXXXXXXXXXXXXXXX-----------------XXXXXXXXXXXXXXXXXXXXXXXXXXXXXXXXXXXXXXX--------------XXXXXXXXXXXXXXXXXXXXXXXXXXXXXXXXXXXXXXXXXX------------XXXXXXXXXXXXX-XXXXXXXXXXXXXXXXXXXXXXXXXXXXXX------------XXXXXXXXXXXXXXXX
