--------------------------------------X-------------------------------------------------------XX-----------------------------------------------------------------------X----------------------------------------------------------------------------------------------------------------
-----------------------------------------------------------------------------------------------------------S-------------------------------------------------------S-S-------------------------------------------------------S----------------------------------------------------------
--------------------------------SSSSSS-SX------------------------------------------------------------------------------------------------------------------------XoSSS---------------------------------------------------------------------------------------S--S-----------------------
----------------------------------------------------------------------------------------------------------------------------------------------------------------------------------------------------------------------------------------------------------------------------------------
----------------------------------------------------------------------------------------------------------------------------------------------------------------------------------------------------------------------------------------------------------------------------------------
-----------------------------------------------------SSS------------------------------------------------------SS------------------------------------------------------------SSS---------SSS--------E------------------------------SSSSS---------SS------------------------------------E-
---S-----------------------------------------------------------------------------------------X----------------------------------------------------XXXXXX------------------------------------------oo------XXXXXX--------------------------------------------------X--X------------------
----------------------------------------------------------------------------------------------------------------------------------------------------------------------------------------------------------------------------------------------------------------------------------------
---S---------E----S----------------------------------------------------o-------------------------------------------------------oo--------------------------------------------------------E--------------------------------E--------------------oo---------------------------------E-----
---Q--------<>----SS---Q-----------------------------SSS------S--QQQ----------X------------------------------SSS--Q-------------oo-------------------------------<>---------------------SSS--------X---------------------<>---------------------SSS--------X-E----------------E--<>-----
------------[]-------------------XX---------X--------------------------------------X----------------------E--------------------------------X---------------------[]---------------E---------E-XX---X---------------------[]---------------E----------------X-----------------<>--[]-----
XX----------[]------------------XXX---------X-------------------------------------XX---------------------<>-------------------------------XX---------------------[]--------------<>-----------X----X---------------------[]--------------<>----------------X----------------X[]--[]-----
-X----E-E---[]---------E---------XX---------X-----E----------E-EE----------------XXX---------------------[]----------EE-E----------------XXX------------------E--[]------E-------[]--------E--X----X-----------------EE--[]----------EE--[]---------------XX---------------XX[]--[]-----
XXXXXXXXXXXXXXXXXXXX-XXXXXXXXXX---X-XXXXXXXXXXXXXXXXXXXXXXXXXXXXXXXXXXXXXXXX----XXXX---------------XXXXXXXXXXXXXXXXXXXXXXXXXXXXXXXXXXXXXXXXX-------------XXXXXXXXXXXX-XXXXXXXXXXXXXX-XXXXXXXXXXXXXXX------------XXXXXXXXXXXXXXXXXXXXXXXXXXXX-XXXXXXXXXXXXXXX----X------XXXXXXXXXXXXXXXXX
