----------------------------------------------------------------------------------------------------------------------------------------------------------------------------------------------------------------------------------------------------------------------X-----------------
------------------------------------------------------------------------------------S--------------------------------------------------------------------------------S------------------------------------------------------------------------------------------------------------------
------------------------------------------------------------------------------------SSSSSSSS----------------------------------------------------------------------------------------------------------------------------------------------------------------o----XX---------------------
----------------------------------------------------------------------------------------------------------------------------------------------------------------------------------------------------------------------------------------------------------------------------------------
----------------------------------------o-----------------------------------------------------------------------------------------------------------------------------------------------------------------------------------------------------------------------------------------------
-------SS--SSSSSS------------------------------------SSS-----SS-----------------------------------------------E------SS----------------------oo-----------------------X------SSS----------------------------------------------E----------------------------X-------------------------SSQ
-------------------------------------------oo-----------------------------------------------------------------------------------------------------XXXXXX---o----------------------------------------------------------------------------------------------X-----------------------------
----------------------------XXX-----------XXX------------------------------------------------------------------------------------------------------------XXXX---------------------------------------------------------------------------------------------------------------------------
------------------------E---------------------------oo-----------------oo---------------------------------E--------------------oo-----------------------------------oo----o------------ooo--------------------------------E-------------------ooo---------------------------------------
---QSS-SS-------S------<>---X--------------------------S----------------oo---------X------------------E--<>---S------S---------------------X--X-------------------E---------------------oo----------------------------E--<>--SS-----------E-----SSS---XXX--X-------------------------SSS
-------------------E---[]-----------------------------------------E----------------X-----------E-----<---[]--------------------------------X---------------------<>--------------------------------X-----------E---------[]--------------<>----------XXXX--X----------------------E-----
------------b----------[]-----XXXXXX-----------------------------<>----------------X----------<>-----[]--[]--------------------------------X---------------------[]-------------------------------XX---------------------[]--------------[]---------X-XXX--X---------------------<>-----
-E---------------------[]------------------------------------EE-E[]---------------XXE--E------[]---XX[]--[]--E--------E-EE---------------XXX---------------------[]-----------E-E----------------XXX---------------------[]--------------[]--------EX-X-X-XX---------------------[]-----
XXXXXXXXXXX--XXXXXXXXXXXXXXXXXX----------XXXXXXXXXXXXXXXXXXXXXXXXXXXXXXXXXXXXXXXXXXXXXXXXX----XXXXXXXXXXXXXXXXXXXXXXXXXXXXXXXXXXXXXXXXXXXXXX---------------XXXXXXXXXX-XXXXXXXXXXXXXXXXXXXXXXXXXXXXXX--XXX------XXXXXXXXXXXXXXXXXXXXXXXXXXXXX---XXXXXXXXXXXXXXXXXXXX------XXXXXXXXXXXXXXX
