------------------------------------------------------------------X---------------------------------------------------------------------------------------------------------------------------------------------------------------------------------------------------------------------
-------------------------------------------------------------------------------S-------Q---------------------------------------------------------------------------------------------------------S-------------------------------------------------------S------------------------------
-----------------------------------------------------------------------------------------------------------------X--SSS-X---------------------------------------------------------------------------------------------------------------------------------------------------------------
----------------------------------------------------------------------------------------------------------------------------------------------------------------------------------------------------------------------------------------------------------------------------------------
----------------------------------------------------------------------------------------------------------------------------------------------------------------------------------------------------------------------------------------------------------------------------------------
-----------------SS--------------------------------------------------------------SSQ-----SSSSS--------------------------------------------EQ--SS-S-------------------------------------------------------SSS----------------------------------------------------------------------------
---S--------------------------------------------------------------------------------------------------------------------------------------------------------------------------XXXXX---------------------------------------------------XXXXXX--------------------------------------------
---S------------------------------------------------------------------------------------------------------------------------------------------------------------------------------------------------------------------------------------------------------------------------------------
---S---------E----SS-------E--E---------------------------------------------------------------------oo--------------------------------E--------------------oo---------------------------------E-------o------------oo---------------------------------E--------------------oo-----------
---X--------<>----SS------XX-<>----------E-------------X-------------------------SSS------QSQSSS----------------------------------E--<>--SSS----------------oS---------X--XX-----------------<>---------------------oo-------------------------------<>------QQ-------------oo----------
-X----------[]-----S------XX-[]---------<>------------------------------------E------------------------------------------------------[]---------------E------------E---X-E-------------------[]------------------------------------------------------[]--------------------------------X
XX----------[]------------[]-[]---------[]------B----------------------------<>------------------------------------------------------[]--------------<------------X----X-----------------<>--[]-------------------------------E<-----------------<>--[]-------------------------------XX
XX-------E--[]---------E--[]-[]---------[]------b---X-X----------------------[]-------------E----------------EEE---------------------[]----------EE--[----------------XX-----------------[]--[]-----------E-EE---------------EX[-----------------[]--[]----------EE-E----------------XXX
XXXXXXXXXXXXXXXXXXXXXXXXXXXXXXXXXXXXXXXXXXXXXXXXX--X-XXX--XXX---------XXXXXXXXXXXXXXXXXXXXXXXXXXXXXXXXXX--XXXXXX---XX------XXXXXXXXXXXXXXXXXXXXXXXXXXXXXXXXXXXXXXXXXXXXX-----------XXXXXXXXXXXXXXXXXXXXXXXXXXXXXXXXXXXXXXXXXXXXX----X------XXXXXXXXXXXXX--XXXXXXXXXXXXXXXXXXXXXXXXXXXXXX
