---------------------------------------------------------------------------------------------------------------X------------------------------------------------------------------------------------------------------------------------------------------------------------------------
-------------------------------------------------------X---------------------------------------------------S-S-------------------------------------------------------S-------------------------------------------------------S----------------------------------------------------------
---------------------------------------------------------------------------------------------------------XoSSS-----------------------------------------------------------------------------------------------------------------------------------------------S--------------------------
----------------------------------------------------------------------------------------------------------------------------------------------------------------------------------------------------------------------------------------------------------------------------------------
------------------------------------------E---------------------------------------------------------------------------------------------------------------------------------------------------------------------------------------------------------------------------------------------
--------------------------------------------------------------------------------------------------------------------------------------------o-------------------------E---S--SS---------------------o-------------------------S-------------------------------------------------------E-
---S------------------------------------------oooo----------------------------------------XXXXX---------------------------------------------------XXXXXX--------------------------------------------------XXXXXX--------------------------------------------------XX-X------------------
---S--------------S--------E------------------------------------------------------------------------------------------------------------------------------------------------------------------------------------------------------------------------------------------------------------
---S---------E----S--------E-------------------------------------------oo-----------------------------------------------------ooo---------------------------------E--------------------oo---------------------------------E-------------------ooo---------------------------------E-----
------------<>----SS------<>--X-----------XXXX-----------------------------------------------------------<>--------------------------------X--XX-----------------<>---------------------oo---------X--XX-----------------<>---------------------o----------X-E----------------E--<>---S-
------------[]----S-------[]--X---X-------XXX------------------------------------------------------------[]--------------------------------X---------------------[]---------------E----------------X---------------------[]---------------E----------------X---------------------[]-----
XX----------[]------------[]-XX--XXX------XXX--------------------------------------<---------------------[]------------------------------XXX---------------------[]--------------<>----------------X---------------------[]--------------<----------------XX---------------------[]-----
XX----------[]---------E--[]-XX---XXE----XXXX---------------E-E-EE----------------E[-----------------[E--[]----------EE-E----------------XXX---------------------[]----------EE-E[]---------------XX---------------------[]----------EE-E[E--------------XXX-----------------EE--[]-----
XXXXXXXXXXXXXXXXXXXXXXXXXXXXXXX---X-XXXXXXXXXX-XXXXXXXXXXXXXXXXXXXXXXXXXXXXXXXXXXXXX-------------XXXXXXXXXXXX-XXXXXXXXXXXXXXXXXXXXXXXXXXXXXX-------------XXXXXXXXXXXXXXXXXXXXXXXXXXXXXXXXXXXXXXXXXXX-------------XXXXXXXXXXXXXXXXXXXXXXXXXXXXX-XXXXXXXXXXXXX---XX------XXXXXXXXXXXXXXXXX
