---------------------------------------------------------------------------------------------------------------X-----------------------------------------------------------------------------------------------------------------------------------------------------------------------X
-----------------------------------------------------------------------------------------------------------S-S-----------------------------------------------------X-S---------------------------------------------------------------------------------------------------------------S--
------------------------------------------------------------------------------------------------X---o---XXSSSSSS------------------------------------------------------------------------------------------------------------------------------------------------------------------------
----------------------------------------------------------------------------------------------------------------------------------------------------------------------------------------------------------------------------------------------------------------------------------------
----------------------------------------------------------------------------------------------------------------------------------------------------------------------------------------------------------------------------------------------------------------------------------------
------------------------------o--------------------------------------------------------------------------------------SSS----------------------------------------------------SSS---------SSS-----------------------------------E------SS-------------------------------------------------
------------------------------------------------------------------------------------------X-XXX----------------------------------------------------------------------------------------------------------------------------------------------------------------------XXX---o------------
-------------------------------------------------------------------------------------------------X-------------------------------------------------------XXX-------------------------------------------------------------------------------------------------------------XXX------------
-------------------------X---------------------------------------------oo------------------------------------------------------SS?-----------------------------------------------------S----------------------------------E--------------------oo------------------------------------o--
------------------------XX-------?-------------------------------QQQ------------X------------------------<E----------SSS-------------------X--------------------------------SSS---------SSS--------X------------------E--<>---S--Q---SS--------------------X----------------------E-----
E-----E----------------XXX-----------------------X----E---------------------------XX---------------------<>-------------------------E------X------X-------------------------------E---------E------X-----------E---------[]--------------------------------X---------------------<>-----
-----<>---------------XXXX-----------------------X-------------------------------XXX---------------------[]-------------------------------XX---------------------<>--------------<>----------------X----------<>---------[]-------------------------------XX---------------------[]-----
E-E--[]-----EE-----X-XXXX----------------E-E-XX--X-----------E-------------------XXX------------------E--[]-----------E-E----------------XXX---------------------[]-------------E[]---------------XX----------[]---------[]----------EE-E----------------XXX---------------------[]-----
XXXXXXXXXXXXXXXXXXXXXXXX----XXXXXX-XXXXXXXXXXXXXXXXXXXXXXXXXXXXXXXXXXXXXXXXXXX--XXXX---------------XXXXXXXXXXXXXXXXXXXXXXXXXXXXXXXXXXXXXXXXX---------------XXXXXXXXXXXXXXXXXXXXXXXXX-XXXXXXXXXXXXXXXXX-XXX----XXXXXXXXXXXXXXXXXXXXXXXXXXXXXXXXXXXXXXXXXXXXXX---------------XXXXXXXXXXXXX
