---------------------------------------------------------------------------------------------------------------X------------------------------------------------------------------------------------------------------------------------------------------------------------------------
-------------------------------------------------------------------------------------------------------------S-------------------------------------------------------S-----------------------------------------------------S-XS------------------------------------------------------S--
S-----SSSS------------------------------------------------------------------------------------------------------------------------------------------------------------------------------------------------------X-------SSSSSSSS--------------------------------------------------------
----------------------------------------------------------------------------------------------------------------------------------------------------------------------------------------------------------------------------------------------------------------------------------------
--------------------------------------------------------E-------------------------------------------------------------------------------------------------------------------------------------------------------------------------------------------------------------------------------
----------------------------------------------------------------------------------------------------------------------------------------------------------------------E----SSSS---------S---------------------------------------------------------------------------------------------S-
---S------------------------------------------------------------------------------oo----XXXXXXX---------------------------------------------------XXXXXX-------------------------------------------------------------------------------------------------------------XXX---o------------
---S--------------S-----------XX-----------------------------------------------------------------------------------------------------------------------------------------------------------------------------------------------------------------------------------------XXXX-----------
---S----SS--------S--------EE-XX--------------------------------------------------------------------------E-------o------------oo---------------------------------E--------------------o------------------------------------------------------ooo-----------------------------------oo--
X------------E----SS------XX--X----------E------------------------E----------------X---------------------<>---------------------oo------------XX-----------------<>----------SS---------SSS--------X------------------E-------SS----------E----------------X---------------------------S
XX----------<>----X-------XX-XX--E------<>-----------------------<>------------X---X---------------------[]--------------------------------X---------------------[]---------------E---------E------X----------------------E--------------<>------------E---X---------------------<E-----
XX----------[]------------XX--X---------[]-----------<>----------[]------------X---X-----------------<>--[]-------------------------------XX---------------------[]--------------<>----------------X---------------------<>--------------[]----------------X---------------------<>-----
XXX---------[]---------E--XX-XX---------[]-----------[]----------[]--------EE--X---X-----------------[]--[]-----------E-E----------------XXX------------------E--[]----------E---[]----------------X---------------------[]---------E-E--[]---------------XX---------------------[]-----
XXXXXXXXXXXXXXXXXXXXXXXXXXXXXXX-XXXXXXXXXXXXXXXXXXXXXXXXXXXXXXXXXXXXXX-XXXXXXXXX-XXX------------XXXXXXXXXXXXXXXXXXXXXXXXXXXXXXXXXXXXXXXXXXXX-------------XXXXXXXXXXXXXXXXXXXXXXXXXXXXXXXXXXXXXXXXXXX---------------XXXXXXXXXXXXXXXXXXXXXXXXXXX-XXXXXXXXXXXXX---------------XXXXXXXXXXXXX
