-------------------------------------------------------------------------------------------------------------------------------------------------------------------------------------------------------------------------------X--------------------------------------------------------
-------------------------------------------------------------------------------------------------------------S-------------------------------------------------------S-----------------------------------------------------S-S-----------------------------------------------------S-S--
o---------------------------oo-SS-SSSSS-SoX---X-SSSSSSSS-----------------------------------------------------------------------------------------------------------SX------------------------------------------------------S------------------------------------------------------XSX---
------------------------------------------------SSSSS-----------------------------------------------------------------------------------------------------------------------------------------------------------------------------------------------------------------------------------
------------------E---------------------------S--SSS---S--------------------------------------------------------------------------------------------------------------------------------------------------------------------------------------------------------------------------------
-------------------------------------oo----------------------SSS--------------------o----------------------------------------------------------------------------------------SS---------------------------------------------------SSSSS-------------------------------------------------
---S------------------------------------------SS------------------------------------------XXXXXX--------------------------------------------------XXXXX---------------------------------------------------XXXXXX--------------------------------------------------XXXXXX----------------
---S-----------------------X---------S--------SS----------------------------------------------------------------------------------------------------------------------------------------------------------------------------------------------------------------------------------------
---S--------------S-------XX---------S--------SS-?oo-------------------ooo--------------------------------E-------------------ooo---------------------------------E--------------------ooo-----------------------------------------------------oo---------------------------------------
X------------E----SS-----XXX-------------S----SSS?S?S-S------SSS-------------------X--XX-----------------<>--------------------------------X------------------E--<>----------SS--------------------X---------------------<E---------------------SS-------------------------------<>-----
XX----------<>----------XXXX-X-----------------------------------------------------X---------------------[]-------------------------------XX---------------------[]--------------------------------X---------------------<>---------------E--------------------------------------[]-----
XX----------[]---------XXXXXXX----------------------------------------------------><---------------------[]------------------------------XXX---------------------[]------------------------------->X---------------------[]--------------<>----------------<---------------------[]-----
XX------E---[]--------XXXXXXXX-------------------------------EE-E----------------E][-----------------EE--[]----------EE-E----------------XXX-----------------[E--[]-----------E-EE---------------[][------------------E--[]----------EE--[]---------------E[---------------------[]-----
XXXXXXXXXXXXXXXXXXXXXXXXXXXXXXXXXXXXXXXXXXXXXXXXXXXXXXXXXXXXXXXXXXXXXXXXXXXX--XXXXXX------------XXXXXXXXXXXXX-XXXXXXXXXXXXXXX--XXXXXXXXXXXXX------------XXXXXXXXXXXXXXXXXXXXXXXXXXXXXXXXXXXXXXXXXXXX-------------XXXXXXXXXXXX-XXXXXXXXXXXXXXXXXXXXXXXXXXXXXX---------------XXXXXXXXXXXXX
