-----------------------------------------------------------------------------------X----------------------------------------------------------------------------------------------------------------------------------------------------------------------------------------------------
---------------------------------------------------------------------------------SX------------------------------------------------------S----------------------------------------------------------------------------------------------------------------------------------------------
----SSSSS------------------------------------------------------------------------------------------------------------------------------S------------------------------------------------------------------------------------------------------------------------------------------------
----------------------------------------------------------------------------------------------------------------------------------------------------------------------------------------------------------------------------------------------------------------------------------------
----------------------------------------------------------------------------------------------------------------------------------------------------------------------------------------------------------------------------------------------------------------------------------------
--------------------------------------------------------ooo-----------------------?--SSSSSS--------------------------------------------------SSS--S-----------------------oo----------------------S-----------------------------ooo----------------------XX-----------------------------
--------------------------------------------------------------XXXXXX--------------------------------------------------XXXXX------------------------------------------------------XXX---o----------------------------------------------XXXXXXX-------------------------------------------
---------------------------------------------------------------------XXX-------------------------------------------------------------------------------------------------------------XXXX-----------------------------------------------------------------------------------------------
------------------------------------------oo-------------------------------------------------------oo---------------------------------E--------------------oo-----------------------------------oo-----------------oo-----------------------------------oo-----------------oo-----------
-------------E------------------------E----------------X--X--------------------------QQ-------------oo---------X--X---------------E--<>------QQ-------------oo---------X----------------------E-------Q------QQ----------------X--XXX-----------------E-------Q------------ooo----------
------E-----<>--X--------X-----------<>-----------XX---X----------------------X---E-----------E----------------X---------------------[]--------------------------------X---------------------<>--------------------------------X---------------------<>--------------------------------X
XXX--<>-----[]----------XXXX---------[]-----------X----X---------------------Eo--------------<>----------------X-----------------[]--[]-------------------------------XX---------------------[]------------------------------XXX---------------------[]-------------------------------XX
-XX--[]-E---[]---------E--------E-E--[]-E-------E---X-XX---------------------------------EE-E[]---------------XX-----------------[]--[]----------EE-E----------------XXX---------------------[]----------EE-E----------------XXX---------------------[]----------EE-E----------------XXX
XXXXXXXXXXXXXXXXXXXXXXXXXX--XXXXXXXXXXXXXXXXXXXXXXXXXXXX---------------X-XXXXXXX----XXXXXXXXXXXXXXXXXXXXXXXXXXXX------------XXXXXXXXXXXX--XXXXXXXXXXXXXXXXXXXXXXXXXXXXXX----------------XXXXXXXXXXXXXXXXXXXXXXXXXXXXXXXXXXX-XXXX--------------XXXXXXXXXXXXXXXXXXXXXXXXXXXXXXXXXXXXXXXXXX
