----------------------------X------------------------------------------------------------------------------------------------------------------------------------------X----------------------------------------------------------------------------------------------------------------
----------X-----------------XX-----------------------------------------------------------------------------S-S-----------------------------------------------------S-SX------------------------------------------------------S-------------------------------------------------------S--
--------------------------------------------------------------------------------------------------------SSSSSS-S--------------------------------------------o---XXSSS-------------------------------------------------------------------------------------------------------------------
----------------------------------------------------------------------------------------------------------------------------------------------------------------------------------------------------------------------------------------------------------------------------------------
----------------------------------------------------------------------------------------------------------------------------------------------------------------------------------------------------------------------------------------------------------------------------------------
---------------------------S------------------------------------------------------------------------------------------S-----------------------------------------------------SSSS----------------------------------------------E---SSSSS-----------------------------------------------S-
------------------------------------------------------------------------------------------XXXXX---------------------------------------------------XXXXX---------------------------------------------------XXXXX------------------------------------------------------XX-----------------
---------------------------------------------------------------------------------------------------------------------------------------------------------XXX----------------------------------------------------------------------------------------------------------------------------
--XX---------E-------------------------E------------------------------------------------------------------E--------------------oo------------------------------------------------------SS---------------------------------E--------------------oo---------------------------------E-----
--X---------<>------------------------<>-------------QQ-Q------------o---------XX--X------------------E--<>---------------------oo---------X-----------------------------S--SSSS--------------------------------------E--<>-----------S---------SS---------X---------------------<>---SS
-XXX--------[]----------E-------------[]-------------------------------------XXX--XX---------------------[]--------------------------------X----------------------o---X---------------------E----------------------------[]---------------E----------------X---------------------[]-----
-XXX--------[]---------<>-------------[]------------------------------------XXXXXXXX---------------------[]-------------------------------XX---------------------<>--------------------------------<---------------------[]--------------<>----------------X---------------------[]-----
-XXX--E-EE--[]-----E---[]-------------[]-------------E------EE-E-------------X--XXXX------------------E--[]----------EE-E----------------XXX---------------------[]----------EE-E------------------[-----------------EE--[]----------EE-E[]---------------X[------------------E--[]-----
XXXXXXXXXXXXXXXXXXXXXXXXXXXXXXXXXXXXXXXXXXXXXXXXXXXXXXXXXXXXXXXXXXXXXXXXXXXXXX--XXXX-------------XXXXXXXXXXXXXXXXXXXXXXXXXXXXXXXXXXXXXXXXXXX---------------XXXXXXXXXX-XXXXXXXXXXXXXXXXXXXXXX--XXXXXX-------------XXXXXXXXXXXXXXXXXXXXXXXXXXXXXXXXXXXXXXXXXXX-------------XXXXXXXXXXXXXXX
