----------------------------------------------------------------------------------------------------------------------------------------------------------------------------------------------------------------------------------------------------------------------------------------
-------------------------------------------------------------------------------------------------------------------------------------------------------------------------------------------------S--------------------------------------------------------------------------------------
---------------------------------------------------------------------------------------------------------------------------------------------------------------------------------------------------------------------------------S-SSSSSSSS-S-----------S-------------------------------
----------------------------------------------------------------------------------------------------------------------------------------------------------------------------------------------------------------------------------------------------------------------------------------
----------------------------------------------------------------------------------------------------------------------------------------------------------------------------------------------------------------------------------------------------------------------------------------
--------------------------------------------------------oo--------------------------------------------------------------------------------E------S----------SS----------oooo----------------------S------SS------------------------------------------------------SS---------------------
----------------------------------------------------------------XXXXX-------------------------------------------------XX-X---------------------------------------------X------XXXXXXX--o------------------------------------------------------------------------------------------------
---------------------------X-------------------------------------------------------------------------------------------------------------------------------------------X----------------------------------------------------------------------------------------------------------------
---------------------------X----------------So--------------------------------E--------------------oo---------------------------------E--------------------oo------------------------------------oo----------------oo------------------------------------------------------oo-----------
o-------?----E---ESS---------------------------------------------------------<>------QQ-------Q----------------X---------------------<>--SS-----------------SSS----X---X--XX-----------------<>----------SSS-------------------X------------------E--<>---S--SS---S---------oo---------X
>-----------<>---E-----------XXXXX-------------------------------------------[]--XXX---------------------------X---------------------[]---------------E-----------XX--XX---------------------[]--------------------------------X------X---------X<---[]--------------------------------X
]-----------[]------------XX-------B--------------------------E--------------[]------------------------------XXX---------------------[]--------------<>-----------X-X-XX---------------------[]------------------------------XXX---------------XX[]--[]-------------------------------XX
X-----E-----[]---E-----------------------------------EE-------------------E--[]----------EE-E----------------XXX------------------E--[]----------EE-E[]-------------XXXX---------------------[]-----------E-E----------------XXX--------------XXX[]--[]----------EE-E----------------XXX
XXXXXXXXXXXXXXXXXXXXXXXX----X---XXXXXXXXXXX--XXXXXXXXXXXXXXXX------XXXXXXXXXXXXX----XXXXXXXXXXXXXXXXXXXXXXXXXXXX---XX-------XXXXXXXXXXXXXXXXXXXXXXXXXXXX---XXXXXXXXXXXXX---------------XXXXXXXXXXXXXXXXXXXXXXXXXXXXXXXXXXXXXXXXXXX--------XXXXXXXXXXXXXXXXXXXXXXXXXXXXXXXXXXXXXXXXXXXXXX
