----------------------------------------------------------X------------------------X----------------------------------------------------------------------------------------------------------------------------------------------------------------------------------------------------
-----------------------------------------------------------------------------------------------------------------------------------------X-------------------------------------------------------S-------------------------------------------------------S------------------------------
--------------------------------------------------------------------------------o-------------------------------------------------------------------------------------------------------------------------------------------------------------------------------------------------------
-----------------------------------------o---------------o------------------------------------------------------------------------------------------------------------------------------------------------------------------------------------------------------------------------------
----------------------------------------------------------------------------------------------------------------------------------------------------------------------------------------------------------------------------------------------------------------------------------------
---S--------------S------------------SSSSSSS------------o-----------o-Q----o--------o-------------------------E-oo------------------------E------SS---------------------o-------------------------------------------------------ooo-----------------------E----SSSS---------------------
---S--------------------------------------------------------------------XXXX---------------XX-XXX---------------------XXXXXX--------------------------------------------------XXXXXX--------------------------------------------------XXXXXXX-------------------------------------------
---S------------------------------------------------------------------------------------------------------------------------------------------------------------------------------------------------------------------------------------------------------------------------------------
---S---------E----SS-------E------------------------------------------------------------------------------E---------------------------E-------------------ooo---------------------------------E-------------------ooo---------------------------------E--o-----------------oo-----------
-X----------<>----SS------XX------------S-----------E----------XXXXXXSSS------XXXX-----------------------<>-------XX-----------------<>--------------------------------X--XX-----------------<>---------------------o----------X--XXX----------------<>---------------E-----SS----------
XXXX--------[]------------XX-----------------------<>----------------------------------------------------[]--XXX---------------------[]--XXX--------------------------XX---------------------[]--------------------------------X---------------------[]--------------->----------------X
XXXX--------[]------------XX-----------------------[]---X--------------------------------------------<>--[]----------------------<>--[]------------------------------XXX---------------------[]-------------------------------XX---------------------[]--------------[]----------------X
XXXX----EE--[]X--------E--XX---EE-E-------------EE-[]---Xo-----------------------------------------E-[]--[]----------------------[]--[]-----------E-EE---------------XXX------------------E--[]-----------E-EE---------------XXX---------------------[]----------EE-E[]---------------XX
XXXXXXXXXXXXXXXXXXXXXXXXXXXXXXXXXXXXXXXXX--XXXXXXXXXXXXXXXXXXXXX-X--X---------------XXXXX-----XXXXXXXXXXXXXX---------------XXXXXXXXXXXXX----XXXXXXXXXXXXX--XXXXXXXXXXXXX-------------XXXXXXXXXXXXXXXXXXXXXXXXXXXXXXXXXXXXXXXXXXX------------XXXXXXXXXXXXXXX-XXXXXXXXXXXXXXXXXXXXXXXXXXXX
