--------------------------------------------------------------------------------------------------------------------------------------------------------------------------------------------------------------------------------------------------------------------------------------------------------------------------------------------------------------------------------------------------------------------------------------------------------------------------------------------------------------------------------------------------------------------------------------------------------------------------------------------------------------------------------------------------------------------------------------------------------------------------------------------------------------------------------------------------------------------------------------------------------------------------------------------------------------------------------------------------------------------------------------------------------------------------------------------------------------------------------------------------------------------------------------------------------------------------------------------------------------------------------------------------------------------------------------------------------------------------------------------------------------------------------------------------------
--------------------------------------------------------------------------------------------------------------------------------------------------------------------------------------------------------------------------------------------------------------------------------------------------------------------------------------------------------------------------------------------------------------------------------------------------------------------------------------------------------------------------------------------------------------------------------------------------------------------------------------------------------------------------------------------------------------------------------------------------------------------------------------------------------------------------------------------------------------------------------------------------------------------------------------------------------------------------------------------------------------------------------------------------------------------------------------------------------------------------------------------------------------------------------------------------------------------------------------------------------------------------------------------------------------------------------------------------------------------------------------------------------------------------------------------------------
SSSSSSSSSSSSSSSSSSS--SSS------------------------------------------------------------------o-----o-------------o-SSSSSSSSSSSSSS------------------------------------------------------------SS--------S---S-------oo------------------------------------------------------oo------------oo---------------SSSSS------------------------------------------------ooSSSSSS-SSSSSSS----------------------------------------------------------------------------------oo-------------------------------------------------------------------------SS-------------------------------------SS--SS-------------------------SS-------------S------------S-----------------------------------------------------SSSSS--S-----SSSSSS-----------SS--------------------------SS-------------S------------------------SSSSS----------------------------------------------------------------------------o-------------oo-SSSSS-----------------------------------------------------------------------------------------------SSS--------SSSSSSSSSSSSSS---SS-------------------------------------SSSSSSSSSSSSSS---SS---------SSSSSS--SSS---------------------S-----------------------------------o------------ooo-----------------------------------------------------ooo--SSSS--------------------------S---------------------oo----S-----------------------------------------------------------------------------------------------SSSS--------------SSSSSSSSSSSSSSSSSSSSSS
------S-------SSSSS--SSS--------------------------------------------------------------------------------------------------------------------------------------------------------------------------------SS---------------------------------------------------------------------------------------------S-SSS------------------------------------------------------S-----------------------------------------------------------------------------------------------------------------------------------------------------------------------S-----------------------------------------SS----------------------------------------S------------------------------------------------------------------SSSS----S-----SSSSS----------SSS---------------------------S------------SS------------------------SSSSS---------------------------------------------------------------------------------------------SSSSS-----------------------------------------------------------------------------------------------SSS------------------------SSS-----------------------------------------SS----------SSS-------------SS--------------------------S------------------------------------------------------------------------------------------------------------S-SSS------------------------------------------------------S-----------------------------------------------------------------------------o-----------------SSS---------------------------SS--------
--?---S-------SSSSS--SSS---------------------o---------------------------o---------------------------------oo-----------------oo-----------------------------S-----oo---o----------------SS----oo-------------------------------------------------------------------------o---------------------------oSSSSS---o----------------------------------------------S-SSSS------------------o-------------------------------ooooo--ooo-------S-----oo----------------------------------------oo-----------------------------------------------S-S---------o------------------------------SSS----------------------------------------------------------------o-------------o-------------ooooo---ooo---oSSSSS---S----oSSSSS---oo----SSSS-----------oo--------------S---------oS-SS----o----oooo-----o----oSSSSS---o-----------------------------------o----ooo---------------------------------------------oSSSSS---oo-------------------------ooo--------------------o---------------------------------------?-SSS---oo--------SS--------SSSS-----------oo--------------------------?-SSS--------SSSS-----------SSSS-----------------oo-------S-----------------------------------------------------------------------------------------------------------oSSSSS---oo------o----ooo------SS----oo--------------------S-----oo----------------------------------o------------o---------------------------------------oSSSS-------------------------?-SSS-------
-----S--------SS-SSSSSSS----------------------------------------SS-----------------------------------------XX------------------------------------------------------XX--------------------------XX--------------------------------------------------------------------------------------------------------------XX---------------S------------SSS--------------------S--------------------------------------------XX--------------------------XX-------------X--------------------------XX------------------SSSSS-----------------SQSS----------SQ----------------------------------------?--------------------------------------------------------------------------XS---------SSS-----------------SS---SS----S-SSSS--SXX----------------------------------------SQ------------XX--------------------------XX------------XX---------------SS---------XX----------------------------------------?----S--SSS--SSX------------XX------------X------------------------------------------?SSS----------?SSSS--S-----XX--------------------------S-------------------------------------------------------SX------------S-------?------X------------X---------------------------?-------------------------------------------------------XX------------?-------S-----XX-------------X-------------X----------------S---------XX-------------X----------------------------------------------S-----------------------Q-----------SX-------------------------------
--------------------------------------------------------------------------------------------------------------------------------------------------------------------------------------------------------------------------------------------------------------------------------------------------------------------------------------------------------------------------------------------------------------------------------------------------------------------------------------------------------------------------------------------------------------------------------------------------------------------------------------------------------------------X---------------------------------------------------------------------------------------------------------------------------------------------------------X-----------------------------------------------------------------------------------------------------------------------------------------------------------o---------------------------------------------------------------------o---------------------------------------------------------------------------------------------------------------------------------------------------------------------------------------------------------------------------------------------------------------------------------------------------------------------------------------------------------------------------------------
-SS-------------------S-----------------------------------------------------------------------------------------------------------------------------S-------------------------------------------------------------------------------------------------------------------------------------------------------------------------------------------------------------------------------------------------------------------------------------------------------------------------------------------------------------------------------------------------------------------------------------------------------------------------------------------S-------------------------------------------------------S---------------------------------------------------------------------------------------------------------------------------------------------------------------------------------------------------------------------------------------------------------------------------------------------------------------------------------S-------------------------o-o---------------------------------------------------------------------------------------------------------------------------------------------------------------------------------------------------------------------------------------------------------------------------------------------------------------------------------------------------------------------------------
--S-------------------------------------------SSSS-------------------------SS-------------------------oo-------------------------------------------SSSS-------SSSS------------------------SSS----------ooooo-------------------------SSSSSSSSS------oo----------oo---------------------------------------ooooo------------ooo----------------------------------S----------------SSSS--SSSS-----SS-----------SS--------------------------SSo-----------oooo-----------SSS----------S----------------------------------------------------------------------------------------SSSS----ooooo-----------ooo----------SSSSSSSSSS------ooo------------SSSS-------------------------------------------------oo--SS------oooooo-----------SSSS-------------------------ooo---------oSSS-----------------------ooooo----------ooo-------------------------SS---------------------------E------------ooo---------ooooo-----------Soo-----------S---------------SSSSSSS-----SSSS--------------o-------------o--------oooo----------?------------------SS-----------------------------------?--ooo---------oSoSS--------?--oo----------SS-----------ooooo-----------ooo----------oo------------------------------SSSSS------SSSS-SS------SSS-----------ooo---------oooooo----------SSS-----------SSSS------------------------ooo-----------SSo------------SS---oo------SSS----------------------------------------------------oooSSS-----------oo---------?--oo------
-SSS-S-SSS------SSS---SS------------S---------------------SS---------------------------SSS----XX-------S-----E-------E-------------------E---------------------------------------------------------------??------------------------------------------------------------E------------<>---------------------------------------------------------------------E----------SQQQ---------------------------------------------------------------------------------------------------------S-----E----EQQQ----XX--X----------------------QQQ---------------------------E---------------------??S--------------------------------------------------SS--------------------<>--------------------------------------SSS----SSSSS--------------------------------------------SQQ----------------------------------------------------------------------ES-----------------S--------E----?SSSSS-----------?-----E------SS-------------------------------------------------------------------------Q-------------Q---Q----------------o--E-SSQ----------------------------------SS---------E-----E?SSQQ-------------------------SQQ--------------------------------------------------------E-------?-----E-------------------------------------------------?S----E-------------------------------------------------------E-----------------------------------------------------------------------------------------------QQQQ--------------------o-----X-------E?SSQQ---
----------------S-----------------------------------------------------------------------------XX------------<>--------------X-----------<>---------------------------------------------------------------------B-----------E-E---------------------------E------------<>------------[]-------------------------------------------------------E------------<>-------------------------------------------------------E-----------------------------------------E--------------------------<>------------XX--X-X-------------------------------------------------<>------------------------------------------------------------------------------------------------[]-------------E--------------------------------------------------------------------------------------------------------------------------------------------------------<>--------------------------<>------------XXX-----------<>-------------------------------------------------------------------------------------------------------------------------------------------------------------------------B----------------------------------------------------------------------------------------------<>------------<>---------------E--------------------------------------<>------------------------------------------------------<>----------------------------------------------------------------------------------------------------------------------------XXX---------------
---------------------------------------------------------------------------------------------XXX------------[]--------------X-----------[]---------------------------------------------------------------------b----------<><>---------------------------B------------[]------------[]------------------------------------------------------<>------------[]------------------------------------------------------<>---------------------------B-------------B--------------------------[]------------XX--X---------------------------------------------------[]--------B---------------------------------------------------------------------------------------[]------------<>-------------------------------------------------------------------------------------------------------------------------------------------B-------------]--------------------------[]------------XXX-----------[]---------------------------B--------------------------------------------------------------------------------------------------X-----------------------------------------------------------------------------------------------------------------------------------------[]------------[]--------B---------------------------------------------[]-------------B----------------------------------------[]-------------B-------------B------------------------------------------------------------------------------------------------XXX---------------
------------XX-------EE-E----E-E---------E---------E------------E-E---------E--E--------E---XXXX------------[]-------------XX-----------[]--------E-EE---------------E---------E--E--------------E-------------B----E-EE--[][]--------E------------------b------------[]------------[]----------EEE-----------------------------------------[]------------[]----------------------------------------E-------------[]------E-EE-E-E-------------b-------------b-------------------EE-----[]----E----E--XX--X---E--E-E--E-----------------------E-E-------E-----[]--------b------------------------------------------------------------------------------EE-E-----[]-E----------[]--------EE-E-----------------------------E-----------------------E-EE--------------------------------------E-EEE---------------------------b-------------B--------E--E-E---E-EE-----[]-E----------XXX-----------[]---------------------------b---E-EE-----EE------------------------------------------------------------------------------------X---------E-E---------EE-E------------E-E----------------------------------------------E-E-------E----------------------------------------[]------------[]--------b-------------E--E--------------EE------------[]-------------b--------E----E--------------------------[]-------------b------------Eb--------E--E-------------------------EEEE----------E-EE-E----------------------------------------XX---------------
XXXXXXXXXXXXXXXXXXXXXXXXXXXXXXXXXXXXXXXXXXXXXXXXXXXXXXXXXXXXXXXXXXXXXXXXXXXXXXXXXXXXXXXXXXXXXXXX--XXXXXXXXXXXXXXXXXXXXXXXXXXXXXXXXXXXXXXXXXXXXXXXXXXXXXXXXXXXXXXXXXXXXXXXXXXXXXXXXXXXXXXXXXXXXXXXXXXXXXXXXXXXXXXXXXXXXXXXXXXXXXXXXXXXXXXXXXXXXXXXXXXXXXXXXXXXXXXXXXXXXXXXX-XXXXXXXXXXXXXXXXXXXXXXXXXXXXXXXXXXXXXXXXXXXXXXXXXXXXXXX-XXXXXXXXXXXXXXXXXXXXXXXXXXXXXXXXXXXXXXXXXXXXXXXXXXXXXXXXXXXXXXXXXXXXXXXXXXXXXXXXXXXXXXXXXXXXXXXXXXXXXXXXXXXXXXXXXXXXXXXXXXXXXXXXXXXXXXXXXXXXXXXXXXXXXXXXXXXXXXXXXXXXX-XXX--XXXXXXXXXXXXXXXXXXXXXXX-XXXXXXXXXXXXXXXXXXXXXXXXXXXXXXXXXXXXXXXXXXXXXXXXXXXXXXXXXXXXXXXXXXXXXXXXXXXXXXXXXXXXXXXXXXXXXXXXX-XXXXXXXXXXXXXXXXXXXXXXXXXXXX--XXXXXXXXXXXXXXXXXXXXXXXXXXXXXXXXXXXXXXXXXXXXXXXXXXXXXXXXXXXXXXXXXXXXXXXXXXXXXXXXXXXXXXXXXXXXXXX-XXXXXXXXXXXXXXXXXXXXXXXXXXXXXXXXXXXXXXXXXXXXXXXXXXXXXXXX--XXXXXXXXXXXXXXXXXXXXXXXXXXXXXXXXXXXXXXXXXXXXXXXXXXXXXXXXXXXXXXXXXXXXXXXXXXXXXXXXXXXXXXXXXXXXXXXXXXXXXXXXXXXXXXXXXXXXXXXXXXXXXXXXXXXXXXXXXXXXXXXXXXXXXXX--XXXXXXXXXXXX-XXXXXXXXXXXXXXXXXXXXXXXXXXXXXXXXXXXXXXXXXXXXXXXXXXXXXXXXXXXXXXXXXXXXXXXXXXXXXXXXXXXXXXXXXXXXXXXXXXXXXXXXXXXXXXXXXXXXXXXXXXXXXXXXXXXXXXXXXXXXXXXXXXXXXXXXXXXXXXXXXXXXXXXXXXXXXXXXXXXXXXXXXXXXXXXXXXXXXXXXXXXXXXXXXXXXXXXXXXXXXXXX-XXXXXXXXXXXXXXXXXXXXXXXXXXXXXXXXXXXXXXXXXXXXXXXXXXXXXXX--XXXXXXXXXXX-XXXXXXXXXXXXXXXXXXXXXXXXXXXXXXXXXXXXXXXXXXXXXXXXXXXXXXXXXXXXXXXXXXXXXX--XXXXXXXXXXXXXXXXXXXXXXXXX-XXXXXXXXXXXXXXXXXXXXXXXXXXX-XXXXXXXXXXXXXX
