-----------------------------------------------------------------------------------------------------------------------------------------------------------------------------------------------------------------------------------------------------------------------------------------------------------------------------------------------------------------------------------------------------------------------------------------------------------------------------------------------------------------------------------------------------------------------------------------------------------------------------------------------------------------------------------------------------------------------------------------------------------------------------------------------------------------------------------------------------------------------------------------------------------------------------------------------------------------------------------------------------------------------------X--------------------------------------------------------------------------------------------------------------------------------------------------------------------------------------------------------------------------------------------------------------------------------------------------------------------------------------------------------------------------------------------------------------------------
--------------------------------------------------------------------------------------------------------------------------------------------------------------------------------------------------------------------------------------------------------------------------------------------------------------------------------------------------------------------------------------------------------------------------------------------------------------------------------------------------------------------------------------------------------------------------------------------------------------------------------------------------------------------------------------------------------------------------------------------------------------------------------------------------------------------------------------------------------------------------------------------------------------------------------------------------------------------------------------------------------------------------------------------------------------------------------------------------------------------------------------------------------------------------------------------------------------------------------------------------------------------------------------------------------------------------------------------------------------------------------------------------------------------------------------------------------
SSSSSSSSSSSSSS--------------------------ooSSSSSS-------------------------SS--------------------------------------SSSSS-----------SSS--------SS--SSSSSSSSSS----------------------------SSSSSSSSS-----------------------------------------------SSSSSSSSSSSS-SSSSSSS----------SSSS----------------------------------------S----------SSSS---SS------------------SSSSSS--------------------------------------------------------------------------------------------------------------S-SSSSSSSS--------------------------oo------------------S---------------------------SS------------S-------------------------------------------------------SS-----------SS---------------------------------------------------SSSSSSSSSSSSSS-------------------------------S---------------------------------------------------o------------------------------SSSS----------------------SSSSSSSSSSSSSS-----------------------------SSSSS-SSS---------------------------------------------------------------------------SSSSS---------------?---ooo------------o---------------------------------------------------------------------------------------------------------------------------------------------------------------------------------------SSSSSS-----------SSS--------------------oo---SSS----------SSS------------------------SSSSS--------SSSSSS--SS----SSSSSSSSSSSSSSSSSSSSSSS-S-------------------SSS--------------------------SSS------------SS--------
------S------------------------------------S-SSS------------------------SSS--------------------------------------SSSS-----------SSS---------------------------------------------------SSSSSSSSSSS----------------------------------------------SSSSSSS-------SSSSS-S--------SSS-----------------------------------------S----------SSSS------------------------SSSSS----------------------------------------------------------------------------------------------------------------------------------------------------------------------S--------------------------SSS------------S------------------------------------------------------SSS-----------------------------------------------------------------------------------------------------------------------------------------------------------------------------------------------SSSSS----------------------SSSSSSSSSS---------------------------------SSSSS-SSS---------------------------------------------------------------------------SSSSS--------------------------------------------------------------------S---------------------------S----------------------------------------------------------------------------------------------------------------------------SSS------------S--------------------------SS-----------SSS------------------------SSSS---------SSSSSS-SSSS-----------------------------------------------SSS-------------------------SSSS------------S---------
--?---S----------o------------------------oS-SSS---o----ooooo---oo-----SSSS---------o-oo------------oo--oooo----oSSSSS--------oSSSS----o----------------------------------------------SSSSSSSSSSS--------------------------oo------------oo----SSSSSSS------oSSSSS-S-S----oSSSS-------------------------oo----ooo-------S---------oSSSS---S-------------------oSSSSS---oo----------------------------------o-----oo--------------------------oo------------------------------------------------S-----------------------------------------SS------------------------S-SSS---o-----S-SS----o-----------------------------------------------E-S-S----E----------------------------------------------------------------------------SS-------------------------------------o--o-----oo------o----ooo---------------------------------------------oSSSSS---oo---oooo----------SSSSSSSSSS------------------o-------------oSSSSS-SSS---------------------------oo---o-oo------------------------o-------------oSSSSS---S------------------o---------------------------------------------S---------o-------------------------------------------------------------------------------------oo----o------ooooo-------------------------------oo---oS-SSS---o-----?-SS-----E------------------?-SS---------oSSSS---------o-------------oSSSS---------oSSSSS-SSSS----------------------------------------------SSSS-----------------------oSSSSS---------E-SS-----E---
-----S-------------------------------XX------S-----XX-----------------------------------------------------------S--SS----SX------------XX-----------------X----------SSS---------XX---SSSSSSSSSSS--------------------------XX------------XX-----SSSSS--?------SSSS--S?----S--SS----------------------------------------------SX-----------SS-------------SQS--S--SSS---XX----------------------------------------XX-------SSSQ----------------X---S-SSS??--SS-----------------------------------------X-----------------------------------------X-------------X------------XX------------XX------------S?SSS-------Q--------------------S-SSSS--SSSS----------------S---SSS--SSSS----------------------------------------------------------------------------------------------X-------------XX------------XX---SSSSSSSSSSSS------------?SSS---SSS---XX----SSS----------SSSSSSSSSS-------------------S------------SSSSSSS-SS---------------------------XX---------------------------------------------S--SS----SX------------------------------------------------------SQSS----------SQ--------------------------XX----------------------------SS------------------------XX------------------S----------------------?SSS---------XX------SSS---?X------------------------------------------------------SX--------------------S----------S-SSSS--SS-------------------------------------------------------S------------S-----S-SSSS---SS---S--SSS----SS--
----------------------------------------------------------------------------------------------------------------------------------------------------------XXXXXX--------------------------------------------------------------------------------------------------------------------------------------------------------------------------------------------------------------------------------------------------------------------------------------------------------------------------------------------------------------------------------------------------------------------------------------------------------------------------------------------------------------------------------------------------------------------------------------------------------------------------------------------------------------XX--------------------------------------------------------------------------------------------------------------------------------------------------------------------------------------------------------------------------------------------------------------------------------------------------------------------------------------------------------------------------------------------------------------------------------------------------------------------------------------------------------------------------------------------------------------------------------o---------------------------------------
-SS---------------------------------------------------------------------------------------------------------------------S---------------------------------------------------------------------S-----------------------------------------------------------------------------------S-------------------------------------------------------S-------------------------------------------------------------------------------------------------------------------------------------------------------------------------------------------------------------------------------------------------------------------------------------------------------------------S-----------------------------------------------------------------------------------------------------------------------------------------------------------------------------------------------------------------S-------------S---------------------------S-----------------------------------------------------------------------------------S-------------------------------------------------------------------------------------------------------------------------------------------------------------------------------------------------------------------------------------------------------------------------------------------------------------------S-------------S-------------------------------------------------------S-------------o---------------------------------
--S----------------SS-----------oooo--------oooooo------------------------SSSSS------------------------------------ooSS-SSS-------oSSSS-----------ooo-------------o---------oo----------ooooooo-----------------------So----------oooo----------oooooo--------oooooo----------SSS-SSSSS---E------------------------------ooo--------------S?--------------------oooooo-----------SSS-----------SSS----------So--------------------------SSS---SSSS--Eo--------------SSSS--S---------oo----------SSSS-------------------------SSS----------oooo----------SSSS---------ooooo----------oSSS---------------------------------------------------ooo---------------SSSSSS--------------------SSSS-----------SSS-SS--SS----------------SSSS-----------SSSS-------------S---------SS------------S-------------ooo-------------------------------------ooooo-----------------------oooo----------------S?---------------------ooo--SSS-------SSSS--S-------SS----------------------------oo-----------------------oooo-SSS-------------------------------------------------------------------S-----------------------oooo------------SS--SSSS--------o---------Soo-----------So------------------------------------------------------oo----------oooooo----------SSSS--SSSS------------------SSSSSSS-SS-----SSSSS----------------------SSS-SSS-----ooooo-SS--------------------------------------ooo-------------S?--------------------ooooo-----------So----SS--
-SSS-S-SSS-------------------------------------S-------------------------------------------------------------------------------------------------o?S------------------SS----SS-----E---SSSSS---SS----------------------------E------SS-----E---??SSSSSSS-----??SSSSSS---------------------SSSSSS------------------------------------SSS----SS-------------Q-------SS----------------------------------------------------SSSSSS---------------------SSSSSSS-------------------------o?----X---------------------------E----------------------------------------------------------------------------------------ESSSS---XX-------------------SSS----SSS---SS--------------------SSS---------------------------------------E----------------------------------------------------------------------E-------------------------SSSS------------------SSS-----------------------SSSSS-SSSSS----SS--------------------------SSS----SS--------------------------------------------------------------------------------------------------E-------------E-----------------------------------------------------------------------------------------------Q-----------------------------E------------------------------------------------------------?SSSS-------------------------------<>-----------------------------------------E------------------SSSS--SSS----------------------E------XX----------------S-------------SS-----------SSSSS------------------SSS-
---------------------------------------E---------------------------------------------------------------------------------------------------------------B--------------------------<>----------------------------------------<>------------<>------------------------------------------------------XX---------------------------------------------------------------------------------------------------------------E---------------X----------------------------------------------------XXX-------------------------<>------------------------------------------------------------------------------------------------XX-------------------------------------------------------------------------------------------X-------------------------------------------------------------E------------<>-------------E-----------------------------------------------------------------------------------------------------------------------------------------------------------------------B----------------------------------------XX------------<>-------------------------------------------------------E-------------------------------------------------------E------------<>-------------------------------------------------------E----------------------------------------[]----------------------------------------<>-------------------------------------------------------XXX----------------------------------------------------------------------
--------------------------------------<>-------------B------------<>-----------------------------------------------------------------------------------b--------------S-----------[]----------------------------------------[]------------[]------------------------------------------------------XX--------------------------------------------------------------------------------------------------------------<>--------------------------------------------------------------------XXX-------------------------[]-------------------------------------------------------B---------------------------------------XXX--------------------------------------------------------------------------------------------------------------------------------------------------------<>------------[]------------<>------------------------------------------------------------------------------------------------------------------------------------------<>------------<>-------------B----------------------------------------XX------------[]------------------------------------------------------<>-------------B-----------B----------------------------<>------------[]------------------------------------------------------<>-------------B--------------------------[]----------------------------------------[]------------------------------------------X-----------XXXX----------------------------------------------------------------------
------------XX---------E--------------[]-------------b------E-EE--[]-----------------------E-EE------EE-E--E-E-E------------------------------------------------------------------[]----------------------E-EE-------EE-----[]------------[]-------------XX------------o--------------------------XX-----EE-E--E-E------------------------E-E-----------E-E-------------------------EE--------------E-------------[]------------XXXX-----------E----------------------E--E---------------X--------------------------[]-----------E----------------------------E--------------b------------------------EEE----------EXXXX----------EEE-------------------------------E----E------------------E---------E--E------------------------------------------------------E-E-------------[]-----EE-----[]------------[]--------------------------E--------------E---------E--E-----------E-E-----------E-E----------E--E--------------------------E--------------[]---------E--[]-------------b------------E---------------------------XX------------[]---------E-EE-----------E-E-----------E-E-------------[]-------------b--------E--b----------------------------[]------------[]--------E--E----------EE-E-------------EE-------------[]-------------b--------------------------[]----------------------------------------[]------------------------------------------X----------XXXXX----------------------E-E-----------E-E-------------------------------
XXXXXXXXXXXXXXXXXXXXXXXXXXXXXXXXXXXXXXXXXXXXXXXXXXXXXXXXXXXXXXXXXXXXXXXXXXXXXXXXXXXXXXXXXXXXXXXXXXXXXXXXXXXXXXXXXXXXXXXXXXXXXXXXXXXXXXXXXXXXXXXXXXXXXXXXXX----XXXXXXXXXXXXXXXXXXXXXXXXXXXXXXXXXXXXXXXXXXXXXXXXXXXXXXXXXXXXXXXXXXXXXXXXXXXXXXXXXXXXXXXXXXXXXXXXXXXXXXXXXXXXXXXXXXXXXXXXXXXXXXXXXXXXXX-XXXXXXXXXXXXXXXXXXXXXXXXXXXXXXXXXXXXXXXXXXXXXXXXXXXXXXXXXXXXXXXXXXXXXXXXXXXXXXXXXXXXXXXXXXXXXXXXXXXXXXXXXXXXXXXXXXXXXXXXXXXXXXXXXXXXXXXXXXXXXXXXXXXXXXXXXXXXXXXXXXXXXXXXX--XXXXXXXXXXXXXXXXXXXXXXXXXX-XXXXXXXXXXXXXXXXXXXXXXXXXXXXXXXXXXXXXXXXXXXXXXXXXXXXXXXXXXXXXXXXXXXXXXXXXXXXXXXXXXXXXXXXXXXXXXXXXXXXXXXXXXXX---XXXXXXXXXXXXXXXXXXXXXXXXXXXXXXXXXXXXXXXXXXXXXXXXXXXXXXXXXXXXXXXXXXXXXXXXXXXXXXXXXXXXXXX--XXXXXXXXXXXXXXXXXXXXXXXXXXXXXXXXXXXXXXXXXXXXXXXXXXXXXXXXXXXXXXXXXXXXXXXXXXXXXXXXXXXXXXXXXXXXXXXXXXXXXXXXXXX--XXXXXXXXXXXXXXXXXXXXXXXXXXXXXXXXXXXXXXXXXXXXXXXXXXXXXXXXXXXXXXXXXXXXXXXXXXXXXXXXXXXXXXXXXXXXXXXXXXXXXXXXXXXXXXXXXXXXXXXXXXXXXXXXXXXXXXXXXXXXXXXXXXXXXXXXXXXXXXXXXXXXXXXXXXXXXXXXXXXX--XXXXXXXXXXX-XXXXXXXXXXXXXXXXXXXXXXXXXXXXXXXXXXXXXXXXXXXXXXXXXXXXXXX-XXXXXXXXXXXXXXXXXXXXXXXXXXXXXXXXXXXXXXXXXXXXXXXXXXXXXXX-XXXXXXXXXXXXXXXXXXXXXXXXXXXXXXXXXXXXXXXXXXXXXXXXXXXXXXXXXXXXXXXXXXXXXXXXXXXXXXXXXXXXXXXXXXXXXXXXXXXXXXXXXXXXXXXXXXXXXXXXXXXXXXXXXXXXXXXXXXXXXXXXXXXXXXXXXX-XXXXXXXXXXXXXXXXXXXXXXXXXXXXXXXXXXXXXXXXXXXXXXXXXXXXXXXXXXXXXXXXXXXXXXXXXXXXXXXXXXXXXXXXXXXXXXXXXXXXXXXXXXXXXXXXXXXXXXXXXXXXXXXXXXXXXXXXXXX
