--------------------------------------------------------------------------------------------------------------------------------------------------------------------------------------------------------------------------------------------------------------------------------------------------------------------------------------------------------------------------------------------------------------------------------------------------------------------------------------------------------------------------------------------------------------------------------------------------------------------------------------------------------------------------------------------------------------------------------------------------------------------------------------------------------------------------------------------------------------------------------------------------------------------------------------------------------------------------------------------------------------------------------------------------------------------------------------------------------------------------------------------------------------------------------------------------------------------------------------------------------------------------------------------------------------------------------------------------------------------------------------------------------------------------------------------------------
--------------------------------------------------------------------------------------------------------------------------------------------------------------------------------------------------------------------------------------------------------------------------------------------------------------------------------------------------------------------------------------------------------------------------------------------------------------------------------------------------------------------------------------------------------------------------------------------------------------------------------------------------------------------------------------------------------------------------------------------------------------------------------------------------------------------------------------------------------------------------------------------------------------------------------------------------------------------------------------------------------------------------------------------------------------------------------------------------------------------------------------------------------------------------------------------------------------------------------------------------------------------------------------------------------------------------------------------------------------------------------------------------------------------------------------------------------
SSSSSSSSSSSSSS--------------------------------------------------------SSSSSSSSSSSS-S----------------------------------------oo---------------------------oSS--S--SSSSSSS---SSS------------S---------------------------------------------------SSSSSSSSSSSS-S----------S-SS-------------------------------SSS------------------------------------------------------S-------------------------SSS-------------S-----------SSS----------SSSSS----------------------SSS-SS--SSS-----------------SSSSSSSSSSS-------------------------------SSSSSS--------SSSSSSSSSSSSSS---SS------------SS--------------------------SS---------------------------S---------------------------------------------------------------oo----SS-----------------------SSSS-----------------------SSSSSS--------------------oo------------o----SSS--------------------------------------------------------------oo----------------------------------------------------------------------------------------------------------------SSSSSS------------------------------------SSSSSSSSSSSSSS-------------------------------------------------------------------------------------SSSSS-----------SSS------------------------------------SSSSSSSSS-SSSSSS--SS-----------SSS----------------------------------------------------------------------------------------------------------SSSSSS-----------SS-----------------------------------------------------------------------------o-
------S----------------------------------------------------------------SSSSSS-----------------------------------------------------S----------------------------------------SSS------------S----------------------------------------------------SSSSSSS---------------------------------------------------SS-------------------------------------------------------S-------------------------SSS-------------------------SSS----------SSSSS--------------------------SS-----------------------SSSSSSS-----------------------------------SSSSS------------SS--------------------------S---------------------------S---------------------------S---------------------------------------------------------------------SS------------------------SSS--------------------------SSS---------------------------------------SS----------------------------------------------------------------------------------------------------------------------------------------------------------------------------------SSSSS----------------------------------------SS----------------------------------------------------------------------------------S----------SSSS------------SS-------------------------------------------------------SS-----------SS-----------------------------------------------------------------------------o--------------------------------SSS--------------------------------------------------------------------------------------------
--?---S---------------------------------------------------------------oSSSSSS----------------------------------------------------SS--------------------------------------S-SSS----o-------S-------------------------------------ooooo---oo-----SSSSSSS-----------------------o-------------------------S-SS----o-----------------------------------------------?-SS------------------------SSSS-------------S----------SSSS---------oSSSSS---S-------------oo-------SS----------------------SSSSSSSS----------------------------------oSSSSS---oo--------S---------S-SS-------------S------------S-----oo------SS--------------------------SS----o----------------------S----------------------------------------SSS--------------o--------SSSS------------------------S-SSS---o--------------------------------oS-SSS---oo-----------------------------------------------------------oooooo-ooo----------------------------------ooo---------oooo-------------S-----oo-------------------------------oSSSSS---S----o--------------oooo--oooo-------SS--------o-----------------------------------------oo-----------------------------S----------oSSSS----------?-SS-----o------------------------oooo---------------------SS---------?-SS----oo---------------------------------------------------------------------------------------oooo-----------S-SSS------------S---------oooooo--------ooooo---oo----------------------------------------------
-----S---------------------------------------------SQS-------------------SSS---?--------------QQQ---------------------------------------X-------------------------------S--SS----SS-------------X-------------------SSSSSSSS---------------------SSSS--?------------------------------------------?SSS---------XX---------------SS-----------------------------------------------------------------S---------------------------S-------SS---SS--------------X------------S-------------XX----SSSSSS-S?---------------------SQ-----S------SSS---XX--------SS------------------------------SQ------S-----XX--------------------SS------------------XX---XXX--------SSS---------------------------------------------SS----XX------S----------S------------------------SSS---SS----?-----------------------------------------XX-------------Q-------------Q--------------------------------------------------------------------------------------------------------------XX---------------------------?SSS---S-----XX----S---------SSS----------------------------------------------------------------------XSS----------------------Q-----------XX------------S--------------X-----------------------------------------------------------S--S-----XX-------------------------------------------SS---------S?SSS-----------------------------SSS-------------SSS---?-------------------SSSS--------------------------S-----XX-------------------------------
-------------------------------------------oo---------------------------------------------------------------------------------------------------------------------------------------------------------------------------------------------------------------------------------------------------------------------------------------------------------------------------------------------------------------------------------------------------------------------------------------------------------------------------------------------------------------------------------------------------------------------------------------------------------XXX-XX----------------------------------------------------------------------------------------------------------------------------------------------------------------------------------------------------------------------------------------------------------------------------------------------------------------------------X-X-------------------------X-----------------------------------------------------------------------------------------------------------------------------------------------------------------------------------------------------------------------------------------------------------------------------------------------------------------------------------------------------------------------------------------------------------------------------------
-SS---------------------------------------XXX---------------------------------------------------------------------------------------------------------------------------------------------------------------o-----------------------------------------------------------------------------------------------------------------------------------------------------------------------------------------------------------------S-------------S-----------------------------------------------------------------------------------------------------------------------------S-----------------------------------------------------------------------------------------------------------------------------------------------------------------------S-------------------------------------------------------------------------------------------------------------------------------------------------------------------------------------------------------------------------------------------------------------------------------------------------------------------------------------------------------------------------------------------------------S---------------------------------------------------------------------------------------------------------------------------------------------------------------------------------------------------------------------------------------------------------------------------------------------
--S---------------------------------------------------------SSSSS-SSSS---ooooo--------------------------SSSSSSS-------------------SSSS------------oo-------------oo-------oooo------------SSSS-------------SSS?-----oo-o------------------------ooooooo-----------ooo----------SS--------------oo--------ooooS------------ooo-----------------------------oooS----SSSSS-S--------SSS--------------S---------SSSSSSS-----------S?-------oooo-SSS-------SS-----SS----?--ooo---------oooo--------ooooooo---------------ooo-----------------oooooo--------?ooooo--------------SSS---------S-S---------So------------SSSSS----------------------ooooo--------------o-----------SSS-------------S-----------oo--------oooo------------------------------SSS-------------------oooooo-------------------------------------ooooo-----------SSS--------------------------------------oooo------------------------SSSSS-SSSS----------------------------------------------SSSS----------------------------o--------ooooo-------------------------------------ooooo----------------------------S----------SSSS-?-----------------------------------ooo-----------SSSSSSS------oSSSS----------SSSS--------------------------oo------------ooo--------oooo---------------------------oo----------------------------o-------------------------------------------------ooooo-----------SSSSS-----------------------------------o-oo------------SSSSS-S-----------------
-SSS-S-SSS-------------------E-----------------------------------------??SSSSSS--------------QQQ-Q------------------------<>--------------------------------------SQQ------SSS-------------------------------------SSSSSSS---------------------??SSSSSSS---------o?S----------------------------------------------------------------------------------------------------------------------------------------------------S---------------S----SS------------------------SSQ-------------------??SSSSSSS------------------SSSSSS-----------SSSS--------??SSSSSS--------------------------------------------------------------SSSSSS--------------------------------<>S---------------------------------o-----------SSS--------SSS--------------S--------------------------?SSSSS-----------------E------------<>---------------------------------------------------------------------------------------------------------------------------------------------------------------------------------------------S-------------------------------------??SS?SSS---------------------------------------------------------<>-----------QQQ----------------------------------------------------------------------------S??S---X-------o?S-----------------------S---------E-------------------------E----------------------------------------<>-----------------??SSSSS---------------------------------------------------SSS---------------------------------E--
----------------------------<>--------------------------------------------------------------------------------------------[]---------------------------B---------------------------------------------------------------------------------------------------------------B-----------------------------------------------------------------------E----------------------------------------------------------------------------------------------------------------------------------------------------------------------------------------------------------------X----------------------------------------E-------------------------------------------------------[-----------------------------------------B-------------E--------------------------------------------------------------------<>------------[]---------------------------------------------------------------------E-----------------------------------------------------------------------------------------------------------------------------------------------------------------------XX-----------------------------------------------------[]-------------------------------------------------------------------------------------------------XX-----------------------------------------<>-------------------------B----------------------------------------[]-------------E---------------------------------------------------------------------E--------------------------<>--
----------------------------[]--------------------------------------------------------------------------------------------[]---------------------------B---------------------------------------------------------------------------------------------------------------b---------------------------------------------------------------------------------B---------------------------------------------------------------------------------------------------------------------------------------------------------------------------------------B-------------XX---------------------------------------<>--------------------------<>-------------B-------------SS----------------------------------------b------------<>-------------------------------------------------------B------------[]------------[]---------------------------------------------------------------------B-----------------------------------------------------------------------------------------------------------------------------------------------------------------------XX-----------------------------------------------------[]---------------------------B---------------------------------------------------------------------XX-----------------------------------------[]-----------B-------------b----------------------------------------[]------------<>-------------X------------------------------------------------------<>--------------------------[]--
------------XX------E-EE----[]-----------E--------EEE----------------------------X----------------------E-----------------[]---------------------------b----------------------------------------------------EE----------------------E-EE-EEE-------------XX---------------------E--E----------------------------------------------------E-EE----------E--b----------------------------------------E-E-------------------------E-E----------------------------E---------------------------E-------------XX-------E--E--------------Eo-------------b-------------XX---------E-------------E-E-------------[]--------------------------[]-------------b------------------------E-E-----------EEE--------------B------------[]---E-EE-----EE-E-----------------------EE-E------------b------------[]------E-----[]--------------------------E-----------E-E-----------EEE--------------b------E-EE-E-E------------------------EEE---------EE-E-----------E-EE-------------------------EEE-----------------------------------------E---------E--E-E-------------XX--------E-EE-----------E-E-------------------E-------[]---------------------------b----------------------------------------E----E-EE-----EE-E-----------XX--------------------------E---------EE---[]-------------------------B------------------------EEE-E-----E-----[]---------E--[]-------------X--------------------E-EE--EE------E-EE-EEE------------[]--------------------------[]--
XXXXXXXXXXXXXXXXXXXXXXXXXXXXXXXXXXXXXXXXXXXXXXXXXXXXXXXXXXXXXXXXXXXXXXXXXXXXXXXXXXXXXXXXXXXXXXXXX-XXXXXXXXXXXXXXXXXXXXXXXXXXXXXXXXXXXXXXXXXXXXXXXXXXXXXXXXXXXXXXXXXXXXX-XXXXXXXXXXXXXXXXXXXXXXXXXXXXXXXXXXXXXXXXXXXXXXXXXXXXXXXXXXXXXXXXXXXXXXXXXXXXXXXXXXXXXXXXXXXXXXXXX-XXXXXXXXXXXXXXXXXXXXXXXXXXX-XXXXXXXXXXXXXXXXXXXXXXXXXXXXXXXXXXXXXXXXXXXXXXXXXXXXXXXXXXXXXXXXXXXXXXXXXXXXXXXXXXXXXXXXXXXXXXXXXXXXXXXXXXXXXXXXXXXXXXXXXXXXXXXXXXXXXXXXXXXXXXXXXXXXXXXXXXXXXXXXXXXXXXX-XXXXXXXXXXXXXXXXXXXXXXXXXXXXXXXXXXXXXXXXXXXXXXXXXXXXXXXXXXXXXXXXXXXXXXXXXXXXXXXXXXXXXXXXXXXXXXXXXXXXXXXXXXXXXXXXXXXXXXXXXXXXXXXXXXXXXXXXXXXXXXXXXXXXXXXXXXXXXXXXXXXXXXXX----XXXXXXXXXXXXXXXXXXXXXXXXXXXXXXXXXXXXXXXXXXXXXXXXXXXXXXXXXXXXXXXXXXXXXXXXXXXXXXXXXXXXXXXXXXXXXX-XXXXXXXXXXXXXXXXXXXXXXXXXXX--XXXXXXXXXXXXXXXXXXXXXXXXXXXXXXXXXXXXXXXXXXXXXXXXXXXXXXXXXXXXXXXXXXX-XXXXXXXXXXXXXXXXXXXXXXXXXXXXXXXXXXXXXXXXXXXXXXXXXXXXXXXXXXXXXXXXXXXXX-XXXXXXXXXXXXXXXXXXXXXXXXXXXXXXXXXXXXXXXXXXXXXXXXXXXXXXXX-XXXXXXXXXXXXXXXXXXXXXXXXXXX--XXXXXXXXXXXXXXXXXXXXXXXXXXXXXXXXXXXXXXXXXXXXXXXXXXXXXXXXXXXXXXXXXXXXXXXXXXXXXXXXXXXXXXXXXXXXXXXXXXXXXXXXXXXXX-XXXXXXXXXXXXXXXXXXXXXXXXXXXXXXXXXXXXXXXXXXXXXXXXXXXXXXXXXXXXXXXXXXXXXXXXXXXXXXXXXXXXXXXXXXXXXXXXXXXXXXXXXXXXXXXXXXXXXXXXXXXXXXXXXXXXXXXXXXXX--XXXXXXXXXXXXXXXXXXXXXXXXX---XXXXXXXXXXXXXXXXXXXXXXXXXXXXXXXXXXXXXXXXXXXXXXXXXXXXXXXXXXXXXXXXXXXXXXXXXXXXXXXXXXXXXXXXXXXXXXXXXXXXXXXXXXXXXXXXXXXXXXXXXXXX-XXXXXXXXXXXXX
