-----------------------------------------------------------------------------------------------------------------------------------------------------------------------------------------------------------------------------------------------------------------------------------------------------------------------------------------------------------------------------------------------------------------------------------------------------------------------------------------------------------------------------------------------------------------------------------------------------------------------------------------------------------------------------X--------------------------------------------------------------------------------------------------------------------------------------------------------------------------------------------------------------------------------------------------------------------------------------------------------------------------------------------------------------------------------------------------------------------------------------------------------------------------------------------------------------------------------------------------------------------------------------------------------------------------------------------------------------------------------------------------------------------------------------------------------------------------
--------------------------------------------------------------------------------------------------------------------------------------------------------------------------------------------------------------------------------------------------------------------------------------------------------------------------------------------------------------------------------------------------------------------------------------------------------------------------------------------------------------------------------------------------------------------------------------------------------------------------------------------------------------------------------------------------------------------------------------------------------------------------------------------------------------------------------------------------------------------------------------------------------------------------------------------------------------------------------------------------------------------------------------------------------------------------------------------------------------------------------------------------------------------------------------------------------------------------------------------------------------------------------------------------------------------------------------------------------------------------------------------------------------------------------------------------------
SSSSSSSSSSSSSS-----------------SSS------------SS--------------------o-------------------------------------------------------------S---------SSSSSS--SS------------------SSSSSSSSSSS--------------------S-SSSSSSSSS--------------SSSSSSSSSSSSSS--------------------------------------------------------SSSSSSSSSSSSSS------------------S---------SSSSSS----------------------------------oo--------------------------oo---------------SSSSS------------------------------------------------------S---------------------o---------------SS--S--SSSSSSS-----------------------------------------------------------SS----------------------------------------SS---------------S?--oooo------------------SS------------------------------------SSSSSS-------o--------------SSSSSSSSSSSSSS--------------------------------------------------------SSSSSSSSSSSSSSSSSSSS-SSS------------------------------oo--------------------------------S----------------------------------------SS-------------------------------------------------------------------SSSS----------SSSS--------SSSSSSSSSSSSSS------------o---------------SSSSSS--------------------------------------SSSS------------S-------oo------------------S--------------------------S------------------------------------------S-------oo---S-SS?--------SSSS-SS---------------------------------SSSSSS--------SSSSSSSSSSS--SSSSSSSSSSSSSSS--------------------------oo----------------------------
------S------------------------SS-------------SS---------------------------------------------------------------------------------------------SSSSS-----------------------SSSSSSS--------------------------------------------------------------------------------------------------------------------------SS-------------------------------------S-SSS-------------------------------------------------------------------------------SSSSS------------S---------------------------------------------------------------------------------------------------------------------------------------------------------S-----------------------------------------S-----------------------------------------SS---------------------------------------SSS---------------------------------------------------------------------------------------------SSSSSSS------SSSSSSSSSSS---------------------------------------------------------------S------------------------------------------------------------------------------------------------------------SSSSS----------SSS----------------------------------------------------SSSSS--------------------------------------SSSS----------------------------------------S---------------------------S-----------------------------------------SS-----------------------SSSS---S----------------------------------SSSSS---------SSSSSSSSSS----SSSSSSSS-------------------------------------S-----------------------
--?---S---------------------oS-SS----oo-------SS----------------------ooo-------------------------oooo-----oo--------------------SS----oo---oSSSSS----------------------SSSSSSSS-------------------------------------------------------------------------------------oo------------------------------------S-------------------------S----------oSSSSS---o----------------------------------ooo---ooo--------------------------oo---oSSSSS---o-------SS---------oo-------------------------------------------------------------------------------------------------------------------------------o-----oo---o---S------------------oo-------------------SSS-----------------------ooooooo----------SSS---------------------------------------SSS------------------------------------o----------------------------------oooo-----ooo---------SSSSSSSS------SSSSSS-SSSS---------------------------------------o----------------------SS----o------------------o-----------------S----------------------------------------------oo-----------------oSSSSS---o----oSSSS-----E--------SS-------o---------------------------oSSSSS---S------------------oooooo-oo-----oSSSSS---o------------------ooooo-------------S---------------------------S------------------------------------------------------------------SSSS---S-------oo-------------o-----oo---oSSSSS---SS---SSSSSSSSSS-----SSSSSSS--------------------------------------S-----------------------
-----S------------------X------------XX------------S--------------------------o-----------S-S-------------------S----------S------------X------------S--------------------SSSSS-S?--------------?SSS-----------------------------------------------------------------X-------------XX-----------------------------------------?-S------------------------XX------------S?SSS-------------------------------------?-------------XX------S-----SX------------XX----S-----------------------------------------------------S-------------------------Q-------------SSS-------------Q---------S--------------X------------SQQ------------X--------------------------SQ----------------------------------SS----XX---------------------------?SSS---------?--------------------------------XXXS-------------------------------------------------------SSSS--S----S-SSSS--SSX--------------SSS----------------------------XX---------SSS----------X-----------------------------SS-------------------------------------------------------------------SSS---------SX---S--S------X------------------------------------------------SSS--SXX-------------------------o--------S-----XX----------------------------------------XX------------SQS-----------SQS-----------S-Q------------?SSS---------?------------------S-SSSSSSS----------------------------XX---S--SSS--SSS---SSSSSSS-S?X----SSSSSS------------------------------?--------------Q-----------------
------------------------------------------------------------------------------------------------------------------------------------------------------------------------------------------------------------------------------------------------------------------------------------------------------------------------------------------------------------------------------------------------------------------------------------------------------------------------------------------------------------------------------------------------------------------X---------------o-------------------------------------------------------------------------------------------------------------------------------------------------------------------------------------------------------------------------------------------------------------------------------------------------------------------------------XXX--X----------------------------------------------------------------oo---o------------------------------------------------------------------------------------------------------------oo-----------------------------------------------------------------------------------------------------------------------------------------oo--------------------------------------------------------------------------------------------------------------------------------------------E-o------oo------------------------------------------
-SS-----------------------------------------------------------------------------------------------------------------------------------------------------------------------------------------------------------------------------------------------------------------------------------------------------------------------------------------------------------------------------------------------------------------------------------------------------------------------------------------------------------------------------------------------------------------------------X---------------------------------------------------------------------------------------------------------------------------------------------------------------------------------------------------------------------------------------------------------------------------------S---------------------------------------------------------------------------------------------------------------------XXXXXX----------------------------------------------------------------------------------------------------------X-X---o-o---------------------------S-------------------------------------------------------------------------------------------------------XXX-------------------------------------------------------------S-------------------------------------------------------S------SS-----------XXXXXXX-------------------------------------------------
--S---------------SSSS---------ooooo------------ooo----------Q-------------------------------------------------------------S------SSSS--S----------------------SSSSSSSSS--ooooooo-----------ooo-------------------------SSS-----SS-?------------------S---------SQ-----------ooooo-----------SSSS--------o--oo------------So----------SSSS---------ooooo--------------o-------------------------------------oo------------SS-----------ooooSS---------oooo-------------------------------o------SSSSS-SSSS-------------------SSSS-----SS----------------------------------o-----------------------SSSS------------------------SS------------SSSSSSSSSS--------------------o-----------------------oooo------------------------------o--------ooooo----------SSSS--SSSS----------------------------------oo-------------------------------------oooooo-------oooooooS-----------oo---------ooo-----------------------------o---------SSSS---------------------------------------SSSS-----S-----------------SSSS--SSSS----SS-----SS--------oo--------oooooo--------ooSS-SSS--S---?-------------------------------------E--ooooooo-----------SSSSS--------------------ooooS----------oooo------------------------oooo----------------------------S------------------------------------ooooo------------------X---------------------------------SSS---------ooooo-SSS-----ooooooo-------S???--------------------------oo--------------S-S-------------S-----
-SSS-S-SSS--------------------------------------------------SS-----E-------------E----SSS-----------------------------------------------------------SQQ------------------??SSSSSSS-----------------------------XX------------------------QQQ---------------------S-----E-------?------------------------?--??SS--------------------------------------?-----------------Q---------------E---------------------S-----E-------------------------------------------------------E----------------------------------------<>------------------------SQQQQ--------------------------XX--------------------------------------QQQ---------------------------------------SQ--------??----E-------------------SSS--------------------------------------?-S?SSS------------------------E--S----------------E---------------------------------------------??--?SSSSS-----SSSS--SSS----------------------------E----------------------------S-------------------SS----<>-------------E---------------------------QQQ------------------------------------------------------------------------o--E-SS----------------E-----S--------<>----SS---------------------------------E---------------------??--------------------------------------------QQQ-Q----------Q--------------QQQ-------------------?S-----------------XXX----SS----S-S---------------------------------SSS----S----??SSSSSSSS----SSS-S-SSSS----------------------------E------------------------------
------------------------------------------------------------------<>------------<>----S----------------------E------------------------------------------------------------------------------------------------XXX-----------------------------------------------------<>-------------E----------------------------X-------------------------------------------------------------------<>--------------------------<>-------------E----------------------------------------<>----------------------------------------[]-------------------------------------------------------XX-----------------------------------------------------------------------------------------------XX-------------------------------------------E------------------------------------------------------------------<>-------------E----------------------------------------------------------------------------------<>---------------------------E--------------------------[]------------<>----------------------------------------------------------------------------------------------------------------------------<>--------------[]--------------------------------------<>---------------------------B-------------------------------------------------------------------------------------------------B-----------XXXX-------------------------------------------------------------------------------------------------------------<>------------------------------
------------------------------------------------------------------[]------------[]--------------------------<>-------<>--------------------------------------------------------------------------------------XXXX-----------------------------------------------------[]-------------B---------------------------XX-------------------------------------------------------------------[]--------------------------[]------------<>----------------------------------------[]-----------B----------------------------[]-------------------------------------------------------XX-----------------------------------------------------------------------------------------------XX---------------------------B----------------------------------------------------------------------X-----------[]-------------B----------------------------------------------------------------------------------[]------------------------------------------------------[]------------[]----------------------------------------------------------------------------------------------------------------X-----------[]---------------E--------------------------------------<>---------------------------b---------------------------B---------------------------------------------------------------------b----------XXXXX----------------------------------------B------------------------------------------------XX------------------[]------------------------------
------------XX----------E-----------------------------------E-----[]---EE-E-----[]---------EE-E-------------[]---E---[]-----------------------------------------E-------------------------------------------XXXXX---------E---------------------------E-E------E------[]-------------b----------E----------------XX-----------E-----------------------------------------E-------------[]--------EE-E-E------------[]------------[]----------------------------------------[]--------E--b----------------------------[]-----------E---------------------------EE--------------X----------EEE----------------------------------E-------E--------E-------------------------------XX------E--E-----------------b--------E-EE-----------------------------E--------E------------------XX-----------[]-------------b-----EE-E--E-E--------EE-E--------------------------------------------------------[]---E-E-------E---------------------------E------E-----[]------------[]----------E-E-----------------------E----------E-------E--------------------------------------------------------X-----------[]----------E---------------------------E---------E-EE--[]---------------------------B---------E-EE--------------b------------E-----------E-E-------------E-------------E--------------B----------XXXXX----------------------E-EE--------------b--------------------------------------E----E------------------------[]----------E-E-----------EEE---
XXXXXXXXXXXXXXXXXXXXXXXXXXXXXXXXXXXXXXXXXXXXXXXXXXXXXXX-XXXXXXXXXXXXXXXXXXXXXXXXXXXXXXXXXXXXXXXXXXXXXXXXXXXXXXXXXXXXXXXXXXXXXXXXXXXXXXXXXXXXXXXXXXXXXXXXX-XXXXXXXXXXXXXXXXXXXXXXXXXXXXXXXXXXXXXXXXX---XXXXXXXXXX--XXXXXXXXXXXXXXXXXXXXXXXXXXXXXXXXXXXXXXXXX-XXXXXXXXXXXXXXXXXXXXXXXXXXXXXXXXXXXXXXXXXXXXXXXXXXXXXXXXXXXXXXXXXXXXXXXXXXXXXXXXXXXXXXXXXXXXXXXXXX-XXXXXXXXXXXX-XXXXXXXXXXXXXXXXXXXXXXXXXXXXXXXXXXXXXXXXXXXXXXXXXXXXXXXXXXXXXXXXXXXXXXXXXXXXXXXXXXXXXXXXXXXXXXXXXXXXXXXXXXXXXXXXXXXXXXXXXXXXXX--XXXXXXXXXXXXXXXXXXXXXXXXXXXXXXXXXXXXXXX-XXXXXXXXXXXXXX----XXXXXXXX--XXXXXXXXXXXXXXXXXXXXXXXXXXXXXXXXXXXXXXXXX-XXXXXXXXXXXXXXXXXXXXXXXXXXXXXXXXXXXXXXXXXX-XXXXXXXXXXXXXXXXXXXXXXXXXXXXXXXXXXXXXXXXXXXXXXXXXXXX-XXXXXXXXXXXXXXX-XXXXXXXXXXXXXXXXXXXXXXXXXXXXXXXXXXXXXXXXXX-XXXXXXXXXXXXXXXXXXXXXXXXXXXXXXXXXXXXXXXXXXXXXXXXXXXXXXXXXXXXXXXXXXXXXXXXXXXXXXXXXXX-XXXXXXXXXXXX-XXXXXXXXXXXXXXXXXXXXXXXXXXXX---XXXXXXXXXXXXXXXXXXXXXXXXXXXXXXXXXXXXXXX--XXXXXXXXXXXXXXXXXXXXXXXXXX-XX-------XXXXXXXXXXXXXXXXXXXXXXXXXXXXXXXXXXXXXXXXXXXXX-XXXXXXXXXXXXXXXXXXXXXXXXXXXXXXXXXXXXXXXXXXXXXXXXXXXXXXXXXXXXXXXXXXXXXXXXXXXXXXXXXXXXXXXXXXXXXXXXXXXXXXXXXXXXXXXXXXXXXXXXXXXXXXXXXXXXXXXXXXXXXXXXXXXXXXXXXXXXXXXXXXXXXXXXXXXXXXXXXXXXX-XXXXXXXXXXXXX-XXXXXXXXXXXXXX-XXXXXXXXXXXXXXXXXXXXXXXXXXXXXXXXXXXXXXX--XXXXXXXXXXXXXXXXXXXXXXXXXXXXXXXXXXXXXXXXXXXXXXXXXXXXXXXXXXXXXXXXXXXXXXXXXXXXXXXXXXXXXXXXX-----XXXXXXXXXXXXXXXXXXXXXXXXXXXXXXXXXXXXXXXXXXXXXX
