-----------------------------------------------------------------------------------------------------------------------------------------------------------------------------------------------------------------------------------------------------------------
-----------------------------------------------------------------------------------------------------------------------------------------------------------------------------------------------------------------------------------------------------------------
-----------------------------------------------------------------------------------------------------------------------------------------------------------------------------------------------------------------------------------------------------------------
------------------------------------------------------------------------------------------------------------------------------------------------------------------------------------------E----------------------------------------------------------------------
-----------------------------------------------------------------------------------------------------------------------------------------------------------------------------------------<>----------------------------------------------------------------------
-----------------------------------------------------------------------------------------------------------------------------------------------------------------------------------------[]----------------------------------------------------------------------
------------------------------------------------------------------------------------------------------------------------------------------------------------------------?-----------S----XX-----------------------------------------------------------EXX--------
------------------------------------------------------------------------------------------------------------------------S--------------------------oooo----------------------------------------------------------------------------------------------EXXX--------
--------------------------------------------------------------------------------------------oooooo-------------------------------------------------------------------------------------------------------------------------------------E------------EXXXX--------
-----------E------------------------ooo--------------------oooo-------------------------------------------------------------------------ooo-----------------------------o------------S-------------------oo-----------------------------XXX------X--XXXXX--------
---------------E-----------------------------------E----------------E------------XX----------------------------------------------------------------------------------E--S--------------------------------------------------------------------------XXXXXX--------
--------------<>----------------------------------<>--------------------E--------XXX-------------------------E------------------------------------------------------<>---------------------------------------X-------E----------------------------XXXXXXX--------
--------------[]-----------------------------X----[]-----------------------------XXXX-------E---------------------------X-------------------------------------------[]---X----<>-----------------X-----------X------<>---------------------------XXXXXXXX--------
--------------[]---E--------E---EE-E---------XX---[]------EE----------------X----XXXXX-----<>-----XX---EE-----------X---X-------E--EE-E-----EE-----------E-EE-------[]E--X----[]---E-------------X----EE-----X------[]-----E-----EE-------------XXXXXXXXX--------
XXXXXXXXXXXXXXXXXXXXX<>XXXX<>XXXXXXXXXXX-----XXX--[]XXXXXXXXXXXXXXXXXXXXXXXXX----XXXXXX----[]------XXXXXXXXXXXXXXXXXX---X--XXXXXXXXXXXXXXXXXXXXXXXXXXXXXXXXXXXXXXXXXXXXXXX----XXXXXXXXX----------XXXXXXXXXXXXXXXXXXXXX--XXXXXXXXXXXXXXX--------XXXXXXXXXXXXXXXXXX
XXXXXXXXXXXXXXXXXXXXX[]XXXX[]XXXXXXXXXXX-----XXX--[]XXXXXXXXXXXXXXXXXXXXXXXXX----XXXXXX----[]------XXXXXXXXXXXXXXXXXX---X--XXXXXXXXXXXXXXXXXXXXXXXXXXXXXXXXXXXXXXXXXXXXXXX----XXXXXXXXX----------XXXXXXXXXXXXXXXXXXXXX--XXXXXXXXXXXXXXX--------XXXXXXXXXXXXXXXXXX