--------------------------------------------------------------------------------------------------------------------------------------------------------------------------------------------------------------------------------------------------------------------------------------------------------------------------------------------------------------------------------------------------------------------------------------------------------------------------------------------------------------------------------------------------------------------------------------------------------------------------------------------------------------------------------------------------------------------------------------------------------------------------------------------------------------------------------------------------------------------------------------------------------------------------------------------------------------------------------------------------------------------------------------------------------------------------------------------------------------------------------------------------------------------------------------------------------------------------------------------------------------------------------------------------------------------------------------------------------------------------------------------------------------------------------------------------------
--------------------------------------------------------------------------------------------------------------------------------------------------------------------------------------------------------------------------------------------------------------------------------------------------------------------------------------------------------------------------------------------------------------------------------------------------------------------------------------------------------------------------------------------------------------------------------------------------------------------------------------------------------------------------------------------------------------------------------------------------------------------------------------------------------------------------------------------------------------------------------------------------------------------------------------------------------------------------------------------------------------------------------------------------------------------------------------------------------------------------------------------------------------------------------------------------------------------------------------------------------------------------------------------------------------------------------------------------------------------------------------------------------------------------------------------------------
SSSSSSSSSSSSSS-------------------------ooo-------------------------------------------SSSS---SS-------------------SSSSS--------SSSSSS------------S-----------------------SSSSSSSSSSSSSS--------------SSSSSS-SSS---------------------------------SSSSS------------S---------------------------------------------------SSSSSSSSSSSSSS--------------------------------S--------o--------------------------------------------------------------------------S----------------?--oooo-------------------------------------------------------S----------------------------SSSSSS-------------------------------------------------------ooo--------------------------------------S-------------S--------------------------SSS--------------------------------------------------SSSSSSSSSSSSSS----------------------------SSSSSS----------------------------------------S------------E----------------------------------------SSS------------------------------------o---------------SSSSS---S------------------SSSSSS----------------------------------------------------------------------------o-------------------S---------------SSSSSSSS--------------SSSSSS----------------------------------------------------------------------------------SS------------S-------------------------------------------o---------------------------------------------------SSSS---------------------------------------SS-------------S-----------------------------o----ooo
------S------------------------------------------------------------------------------SSSS------------------------SSSSS---------S-SSS----------------------------------------SSS---------------------SSSSSS-SSS---------------------------------SSSSS------------S-------------------------------------------------------------------------------------------------S-----------------------------------------------------------------------------------S------------------------------------------------------------------------------------------------------------SSSSS---SS-------------------------------------------------------------------------------------------S-------------S-------------------------SSS-----------------------------------------------------------------------------------------------SSSS----------------------------------------S-----------------------------------------------------SSS----------------------------------------------------SSSS----S-------------------SSSSS-----------------------------------------------------------------------------------------------SS----------------------------------------SSS--------------------------------------------------------------------S------------SSS------------S------------------------------------------------------------------------------------------------SSS--------------------------------------------------------------------------------------------
--?---S--------------------------------------o----------o---------------------------oSSSS-----------------------oSSSSS---oo---oS-SSS---------?----------------------------?--SS--------oooo----o----oSSSSS-SSS------------------o-------------oSSSSS---oo-------S-----------------------o---------------oo---oooo-------------------------------oooooo--o--------------------------------------------------------oo-----------------------------------S-------------------------ooo-----------------------------------------------------ooo--oooo---oooo----------oSSSSS---SS-------------------------------o----------------------------------------------------------SS------------SS----o------oo-----------SSSS----------------------------------------------------------------------------------------oo----SSSSS----------------------------------------S----------------------------------------------------SSSS---------------------------------------------------oSSSS----S------------------oSSSSS---o---------------------------oo------------------------------------------------SS----oo------SS----o---------------------------------ESS-S---------------oooo-----------------------------------------------------------oS-SSS---o--------S--------------------------o----ooo-----------------oooo----------o---------------------------oSSSSS---oo--------------------o------------------------------------------------------------------
-----S--------------------------------------------------XSS--------------------XX------------S------------------S-SSSS--SSS------SSS---?X---S--------------------------------SS---------------------S-SSSS--SS----------------SS----------X---S--SS----SS------------XX---X----------SSS----------X-------------------------------XX---------SSS-------------------------------------XX-------------Q------------XX---------------------------?SSS------------------------------------------------------SS------------S-------------------------------------------S--SSS--SSX------------S?S-S------------------------------X----------S---------S?SSS-------------------------------------XX-----------------------------------------?SSS----------------------------------------------------------------o-----S-SSSS--S?X---------------------------QQQS---------XX----------------------------------------XX----------------------------SSS-----------------------SQSS----------S---------------------S-----XX--------------------------XX--------------SSS----------X--------------------------XX------------XX--------------------------------SSSSSSSSSS---------------------------X-----------------------------------------X------------XX-------------X--------------------------XX----------------S-S------------XS-----------------------------S-----XX-------------?SSS----------------------------------------------------------------------
--------------------------------------------------------------------------------------------------------------------------------------------------------------------------------------------------------------------------------------------------------------------------XXX-----------------------------------------------------XXX---------------------------------------------------------------------------------------------------------------------------------------------------------------------------------------------------------------------------------------------------------------------------------------------------------------------------------------------------------------------------------------XXX---------------------------------------------------------------------------------------------------------------o---------------------------------------------------------------------------------------------------------------------------------------------------------------------------------------------------X-----------------------------------------------------------------------------------------------------------------------------------------------------------------------------------------------------------------------------------------------------------------------------------------------------------------------------------------------------------------------------------------------------
-SS-----------------------------------------------------------------------------------------S---------------------------------------------------------------------------------------------------------------S-------------------------------------------------------------------------------------------------------------------------------------------------------------------------------------------------------------------------------------------------------------------------------------------------------------------------------------------------------------------------------------------------------------------------------------------------------------------------------------------------------------------------------------------------------------------------------------------------------------------------------------------------------------------S-----------------------------------------S-------------------------------------------------------S---------------------------------------------------------------------------------------------------------------------------------------------------------------S---------------------------------------------------------------------------------------------------------------------------------------------------------------------------------------------------------------------------------------------------------------------------------S-------------------
--S-----------------SSSSSS------oE------------SSSS------------------------Soo---------------S?------------S-------ooooo---------oooooo----------SSSSSSSSSS-----S-----------oo-oo------------------------oo--SSS----------------------------------oooo-SSS-------oooo--------------o---------------------------------------oo----------------------------------------oo----------SSSo------------S-----------oo------------------------------------------ooo-----------oo-----------------------------------------oo------------oo-----------------------------------ooooooo-------------------------o--------------------------------------------------------------------SSS----------SSSS------------------------SSSSSSS-----------o---------SSSS--S-----------------------o-----------SQ------------------------ooooo---------------------------------------oooo--------------S----------SS-----------oooo-----------SSSSSS---------oo------------oo-------------------------S--SS---------------------ooooo----------SSSSS-SSSS----So----------------o----------So------------E------------SSS-----------oooS-------------oo---------------------oooooo-------------------------SS-------------------------Soo-----------oooo---------ooooo----------SSSS------------------------SS------------------------------------------------------------------oooooo------------------------SSSS-------------SSSSSS-----SSSSS-S-----------SS------------------
-SSS-S-SSS---------------------SSSS----E---------------------------E------------------S-----SSS--------------------SSS---------S?SSSS------------------------------------??S-?SSSS--------------------SSS----SS-----------------------------------------------------------------------S-------------------------------o--??S---X-----------------------------------o-----------------------------------------------E-------------------------------------------------??----E------------------------------------------------------------------------------------------SS------------------------------------------------------------XX---------------------------------------------------------------------------------------------------------------------SSS----<>-------o?S---XX--------------------------E---SSSSSSS------QQQ--------------------QQQQQ---------------------------------------------------------------------------------------------------------------Q---------SS-----------------------------------------------------------------------------------------?SSSS----X-----------------------------------o-----EX----------------SSSSSSS----------------------------------------------------------------------------------------------------------------------------------------------<>---------------------------E---------------------S---------------------------------------S--------------------------SSS-------------SSS---XX--
--------------------------------------<>--------------------------<>-------------E-----------------------------------------------------------------------------------E---------------------------------------------------------------------E-------------------------------------------------------E---------------------------XX------------E--------------------------------------------------------------------<>------------------------------------------------------<>-----------------------------------------------------------------------------------E-------------------------------------------------------E-----------XXX----------------------------------------------------------------------------------------------------------------------------[]------------XXX------------E------------<>-----------------------------------------------------------------------------------------------------------------------------E-------------B-----------------------------------------------------------------------------------E----------------------------------------XX-----------------------------------------XX---------------------------------------------------------------------------------------------------------------------------------------------------------------------[]--------------------------<>--------------------------------------------------------------------------------------------------------------XX--
--------------------------------------[]--------------------------[]------------<>----------------------------------------------------------------------------------<>--------------X-----------------------------------------------------<>------------------------------------------------------<>---------------------------XX----------------------------------------b----------------------------------------[]------------------------------------------------------[]----------------------------------------------------------------------------------<>------------------------------------------------------<>----------XXXX----------------------------------------------------------------------------------------------------------------------------[]------------XXX-----------<>------------[]-------------------------------------------------------B-----------------------------------------B---------------------------B-------------b----------------------------------------------------------------------------------<>---------------------------B------------XX-----------------------------------------XX----------------------------------------------------------------------------------B---------------------------B----------------------------------------------------X-[]--------------------------[]---------------------------B----------------------------------------------------------------------------------XX--
------------XX------------------E-----[]--------------------------[]------------[]----------E-E-----------E-E----------------------------E--------------------------[]-------------XX-------EE-E---------------------------EE-------------[]------------------------------------------------------[]-----EE-E--E-E-------------XX-------------------E-EE-E---------------b------------E-------------E-------------[]--------E-EE-------------EE---------------------------[]--------EE-E-------------EE----------------------------------EE-E--E-E------E--E--[]------------------------EEE-------------E-------------[]----E---EXXXXX-----------EE-----------EEE--------------------------------------E-EE-------------------------------------------------E-----[]-------------XX-----------[]-----EE-----[]-E-----------o------EE-----E-E-------------------------b----------E-E-------------E--------------b---------------------------b-------------B----------E-E-----------E-------------EEE-----------------------------------------[]--------------------------Eb------------XX-------------E-------------E-------------X----------EEE--------------------EE-E--E-E------------E---------E-EE--------------Eb---------------------------b------------------------EEE--------------E----E----XXX[]---------E--EE------------[]----------EEE--------------b------------E----------------------------------------------E----------------E---XXXX--
XXXXXXXXXXXXXXXXXXXXXXXXXXXXXXXXXXXXXXXXXXXXXXXXXXXXXXXXXXXXXXXXXXXXXXXXXXXXXXXXXXXXXXXXXXXXXXXXXXXXXXXXXXXXXXXXXXXXXXXXXXXXXXXXXXXXXXXXXXXXXXXXXXXXXXXXXXXXXXXXXXXXXXXXXXXXXXXXXXXXXXXXXXXXXXXXXXXXXXXXXXXXXXXXXXXXXXXXXXXXXXX-XXXXXXXXXXXXXXXXXXXXXXXXXXXXXXXXXXXXXXXXXX----XXXXXXXXXXXXXXXXXXXXXXXXXXXXXXXXXXXXXXXXXXXXXXXXXXXX--XXXXXXXXXXXXXXXXXXXXXXXXXXXXXXXXXXXXXXXXXXXXXXXXXXXXXXXXXXXXXXXXXXX-XXXXXXXXXXXXXXXXXXXXXXXXXXXXXXXXXXXXXXXXXXXXXXXXXXXXXXXXXXXXXXXXXXXXXXXXXXXXXXXXXXXXXXXXXXXXXXXXXXXXXXXXXXXXXXX-XXXXXXXXXXXXX-XXXXXXXXXXXXXXXXXXXXXXXXXXXXXXXXXXXXXXXXXXXXXXXXXXXXXXXXXXXXXXXXXXXXXXXXXXXXXXXXXXXX--XXXXXXXXXX--XXXXXXXXXXXXXXXXXXXXXXXXXXXXXXXXXXXXXXXXXXXXXXXXXXXXXXXXXXXXXXXXXXXXXXXXXXXXXXXXXXXX---XXXXXXXXXXXXXXXXXXXXXXXXXXXXXXXXXXXXXXXXXXXXXXXXXXXXXXXXXXXXXXXXXXXXXXXXXXXXXXXXXXXXXXXXXXXXXXXXXXXXXXXXXXXXX-XXXXXXXXXXXX-XXXXXXXXXXXXXXXXXXXXXXXXXXXXXXXXXXXXXXXXXXXXXXXXXXXXXXXXXXXXXXXXXXXXXXXXXXXXXXXXXXXXXXXXXXXXXXXXXXXXXXXXXXXXXXXXXXXXXXXXXXXXXXXXXXXXXXXXXXXXXXXXXXXXXXXXXXXXXXXXXXXXXXXXXXXXXXXXXXXXXX-XXXXXXXXXXXXXXXXXXXXXXXXXXXXXXXXXXXXXXXXXXXXXXXXXXXXXXXXXXXXXXXXXXXXX--XXXXXXXXXXX-XXXXXXXXXXXXX-XXXXXXXXXXXXXXXXXXXXXXXXXXXXXXXXXXXXXXXXXXXXXXXXXXXXXXXXXXXXXXXXXXXXXXXXXXXXXXXXXXXXXXXXXXXXXXXXXXXXXXXXXXXXXXXXXXXXXXXXXXXXXXXXXXXXXXXXXXXXXXXXXXXXXXXX-XXXXXXXXXXXXXXXXXXXXXXXXXXXXXXXXXXXXXXXXXXXXXXXXXXXXXXXXXXXXXXXXXXXXXXXXXXXXXXXXXXXXXXXXXXXXXXXXXXXXXXXXXXXXXXXXXXXXXXXXXXXXXXX-XXXXXXXXXXXXX
