---------------------------------------------------------------------------------------------------------------------------------------------------------------------------------------------------------------------------------------------------------------------------------------------------------------------------------------------------------------------------------------------------X-------------------------------------------------------------------------------------------------------------------------------------------------------------------------------------------------------------------------------------------------------------------------------------------------------------------------------------------------------------------------------------------------------------------------------------------------------------------------------------------------------------------------------------------------------------------------------------------------------------------------X--------------------------------------------------------------------------------------------------------------------------------------------------------------------------------------------------------------------------------------------------------------------------------------------------------------------------------------------------------------------------------------------------------------------------
--------------------------------------------------------------------------------------------------------------------------------------------------------------------------------------------------------------------------------------------------------------------------------------------------------------------------------------------------------------------------------------------------------------------------------------------------------------------------------------------------------------------------------------------------------------------------------------------------------------------------------------------------------------------------------------------------------------------------------------------------------------------------------------------------------------------------------------------------------------------------------------------------------------------------------------------------------------------------------------------------------------------------------------------------------------------------------------------------------------------------------------------------------------------------------------------------------------------------------------------------------------------------------------------------------------------------------------------------------------------------------------------------------------------------------------------------------
SSSSSSSSSSSSSSSSSSSSSSSSSSSS-----------------------------------------------------ooo----------------------------SSSSSSSSSSSSSS----------------------------------------------------------SSSS------------SS--------------------------S------------SS-----------SSSS--------------------------------------------------SSSSSS---S-------SSS-------------------------------------------------------SS?-ooooo----------------------------------------oo------------oo----------------------------------------------------------------------SSSSSS--------------------------------------------------------------------------------SSS----------S--S-----S-SS--------------------------------------------------------SSSSSSSSSS----------------oo-------------------------ooo--------------SSSSSS-SSSS-------SS--------SSS-SS--SSS-SS-----------------S----------------------o-----SS--------------------------------------------------SSSSSSSSSSS-----------------SSSSSS--SS------------------SSS-SS--------SSSSSSSSSSS--------SSS?SoooS---SS-------------------------------------SSSSSSSSSSSSSS----------------------------------------oo----------------------------SS-SSSSSSSSSSS----SS--------S----S----SSSSSSSSSSSSSSSSSS---S--------------------------------------SSSSS--SSS------SSSS----------------------------------oo----------------------------------------------ES----------------------SSSSSSSS----------------------------------SSSSSSSSSSSSSS
------S------------SS------------------------------------------------------------------------------------------------SS-------------------------S--------------------------------------SSSSS-----------SSS----------------------------------------S----------SSSSS--------------------------S------------------------SSSSSSSSSS------SSS-----------------------------------------------------------------------------------------------------------------------------------------------------------------------------------------------SSSSS---S----------------------------------------------------------------S-----------SSS-------------S-----------------------------------------------------------------SSSSSSSSSSS------------------------------------------------------------SSSSSSSSS-------SS-------------SS----------------------------------------------------------------------------------------------------------SSSSSSSSSSS------------------SSSSS--SS----------------------SS---------SSSSSSSSSS-------------------------------------------o---------------------------------------------------------------------------------------------------------------------S---------------------------SS--------------------------------------------------SSSSS---SS------SSS-----------------------------------------------------------------------------------SS------------------------SSSS-------------------------------------S--SS--------
--?---S---------S--SS---------------------o-----------------------------------------oooo------------ooo---ooo-----?--SS------------------------SS-------------------------------------oSSSSS---oo----E-SS-----o------------oo------SS-----o------SS---------oSSSSS---oo-----ooo---ooo-------------------------------SSSSSSSSSSS----S-SSS---oo------S-------------------------------------------------------------------------------------------------------------------------------------------o---------------------------o-----oo---oSSSSS---SS---ooooo---o----------------------------oo--------------------S-----oo----SSSS-------------S----------------------------------------o-----oo---oooo-----o----SSSSSSSSSSS-----------------o------------------------------o----------SSSSSSSSSS-----S-SS----oo-------SS------------------------------------------------------------------oo----------ooooo---ooo---o-oo----------SSSSSSSSSS------------------oSSSSS--SS-------o--------------SS--------SSSSSSSSSS----------------------------------------------------------------------------------------------------------------------o----------------------------------------?-SS----oo----------------------SS----------SS-----------------------oooo----------SSSSS--SS------SSSS------------------------------------------------------S-----oo---o-oo-----------E-S------E-----------ooo-----SS-S-----------S-----oo------------------S-SSS--------
-----S------------?S---------------------------------------------------------------------------------------XX--------SS----------------S?SSS----------X-------------X-------------?SSSS--SS----XX---S--SS----SX------------XX-------------X-----------------S--SSS---SX------------XX-------------?-------------------SSSS--SXX------------XX-------------------------------XXXS--------SS---------------------------------------------------------------------------------------------------------------------------------------XX------SS----XX--------------------------S?SSS---------XX--------------------------XX------------S-------------------------------------------------------XX-----------------SSSSSSSSSSS----------------------------SSS--------------------------------SSS--S-------------XX------------S----XXXS-------SSS------------------------------------------------------------------------------------SSSSSSSSSS------------------S--SSS--SS---------------------------S----SSSSSSS-SS------------------------------------------?SSS-------------------------Q-------------SSS---------S?SSS-------------S---------------------------------------------------XX---S----------o-------SS---------------SS------------------------------------S-S-SS-------------S-------------S?SSS--------------S-S?S----SSS-----------XX----S------------S-SSSS---SSS-----------XX----SSSSSSSSS-------------XX-------------X------------?----
----------------------------------------------------------------------------------------------------------------------------------------------------------------------------------------------------------------------------------------------------------------------------------------------------------------------------------------------------------------------------X-------------------------------------------------------------------------------------------------------------------------------------------------------------------------------------------------------------------------------------------------------------------------------------------------------------------------------------------------------------------------------------------------------------------------------------------------X-----------------------------------------------------------------------------------------------------------------------------------------------------------------------------------------------------------------XXXX----------------------------------------------------------------------------------------------------------------------------------------SS------------------------------------------------------------------------------------------------X-X-------------------------------------------------------------------------------------------------------------------------------------------------------
-SS-------------S-----------------------------------------------------------------------------------------------------------------------------------------------------------------------------------------------------------------------------------------------------------------------------------------------------------------------------------------------------o-----------------------------------------------------------------------------------------------------------------------------------------------------------------------------------------------------------------------------------------------------------S-----------------------------------------------------------------------------------S-----------------------------------------------------------------------------------------------------------------------------S-----------------------------------------------------------------------------------S---------------------------S-----------------------------------------S-----------------------------------------------------------------------------------------------------------------------------------------------------------------------------------------------------------------------------------------------------------S-------------S-------------------------------------------------------------------------------------------------------SSS-----------------------------------------------------
--S--------------??-------------------------------------------------------oo--------------------------SSS----------??----------------------------SSS----------oooo--------------o-------ooooo---------oooo------------SSS-----------SSSS--S--------SSSS-------ooooo-----------SS--------------ooo---------------ooo---ooooooo--------ooooo----------SSSS--------------S------------------------------------------------------S----------ooo-------------ooo-----------------------------oo------SSS-------------SSSSSSS-----Soo----------ooooo--------------------------------------SS-------------SSS--o-------ooo---------------SSS---------ooo----------SSS------------------------SSS-----------------------ooooo-o---------oo--------------------------ooo-----------SSSS---------oooo-o--------ooooo---------?--ooo---------------------------SS----------------------SSSSSSSSSS--------------------------------------------ooooo-----------SSSS---------oooo-SSS-------SSSS------------ooo-------ooooooo------------------------SSSSSSSS---------o-------------S-----SS-----------------------------------------------oo---------------------------------------------------SSSS------SS--------------?ooooo--------------------------SS--SSSS--------------------------------SSSSSSS-----------o-----------o-------------------------SSSS-----------------------ooo------------S-----------oo-ooo----------SSSS----------oooo---------ooooo------
-SSS-S-SSS-----SSS---SSS-------S---------------------E-------------------SSSS----E-------------------------------?o--E-SSQ-------------Q--------------------------------------------------SS------------SS-----------------------------------------------------SSS---------------------------------------------------?SSSSSSSS----------------------------------S----------------------ES-----------XXX----------------------------------?S----E-------o-----------------------------------------------------------------------------------S-------------------------------Q---------------E-------------------------------------------------o?S---------------------------------------------------------------SSSSS--SSS--------?-----E--------------------S?S----E-----------------------SSSQ----------------------E?SSQ--------------------SSS-------------------<>-----------------------------------------------------------SSSSS--SSSS-------------------SS----SS----------------------E---------?SSSSSSSSS-------------XXX---------------------------SS-----------------------QQQQ----------------------------------------------------------------------------------XX--------------------------Q---??SSSSSS---------------QQ--------------------------------SS----SSQQ-----------------------------------------------------------------------------------------SSS-----------------------SSSSSSSSS-------------------------------------??SS-----
--------------------E--------------------E----------<>--------------------------XX-----------------------------------------------------------------------------------------------------------------------------------------------------------------------------------------------------------------------------B------------------------------------------------------------------------------------XXX---------------------------------------XX-------------B---------------------------------------------------------------------E------------------------------------------------------<>------------------------------------------------------------------------------------------------------------------------------------------<>-------------E------------XX---------------------------------------------------------------------E--------------------------[]-------------------------------------------------------------------------------------------------------------------------------------------------------XXXX------------------------------------------------------------------------------------------------B-----------------------------------------XX--------------------X--------------------X------------------------------------------------------------------------------------------------E---------------------------------------------------------------------------------------------------------------E----------------
---------------------------<------------------------[]--------------------------XX-------------------------------------------------------------------------------------------------------------------------------------------B---------------------------------------------------------------------------------b--------------------------------------------------------------------X--XS----------XXXX---------------------------------------XX-------------b-------------------------B------------------------------------------<>------------------------------------------------------[]---------------------------B--------------------------------------------------------------------------------------------------------------[]------------<>------------XX-----------------------------------------B--------------------------<>--------------------------[]-------------------------------------------------------------------------------------------------------------------------------------------------------XXXX------------------------------------------------------------------------------------------------b-----------------------------------------XX----------------------------------------XX-----------------------------------------------------------------------------------------------<>---------------------------------------------------------------------------------------------------------------B----------------
------------XX--------E----[X-----E-EE--------------[]--------E-EE--------------XX---------E--EE--------E----E--------------XX---------EE-----------------------------------------E--------------E-------------E-------------b--------------------------------------------------E----E----------------------E--b-----------------------------E------------------------E-E--------------X----------XXXXX--------EEEE---------E-EE---------------X----------------------EEEE----------E--b--------------E---------E-----------------[]--------------------E-EE-EEE------------E-------------[]--------E--E---------------b---------------------------------------E------------EEE--------------E---------E-EEE--------------------------[]------------[]------------XX-----------E-----------------------------b--------------------------[]---E------E-------E-------[]----------------------EE-E----------EE-E-----------E-EE-----------E------------------------------------------E----------------------------------------XXXXX---------------------------E---------E-E---------------------------E------------EE--------------B--------E-EE------------EEE--------------XX----------------------------------------XX---------E-E---------E--E-----------E-EE-----------E-E-----------------------------------------[]-----E-------o-------------E---------E-EE--------------------EE-----EE-----------------------------------------b----------------
XXXXXXXXXXXXXXXXXXXXXXXXXXXXXXXXXXXXXXXXXXXXXXXXXXXXXXXXXXXXXXXXXXXXXXXXXXXXXXXXXXXXXXXXXXXXXXXXXXXXXXXXXXXXXXXXXXXXXXXXXXXXXXXXXXXXXXXXXXX-XXXXXXXXXXXXXXXXXXXXXXXXXXXXXXXXXXXXXXXXXXXXXXXXXXXXXXXXXXXXXXXXXXXXXXXXXXXXXXXXXXXXXXXXXXXXXXXXXXXXXXXXXXXXXXXXXXXXXXXXXXXXXXXXXXXXXXXXXXXXXXXXXXXXXXXXXXXXXXXXXXXXXXXXXXXXXXXXXXXXXXXXXXXXXXXXXXXXXXXXXXXXXXXXXXXXXXXXXXXXXXXX---XXXXXXXXXXX--XXXXXXXXXX--XXXXXXXXXXXXXXXXXXXXXXXXXXXXXXXXXXXXXXXXXXXXXXXXXXXXXXXXXXXXXXXXXXXXXXXXXXXXXXXXXXXXXXXXXXXXXXXXXXXXXXXXXXXXXXXXXXXXXXXXXXXXXXXXXXXXXXXXXXXXXXXXXXXXXXXXXXXXXXXXXXXXXXX-XXXXXXXXXXXXXXXXXXXXXXXXXXXXXXXXXXXXXXXXXXXXXXXXXXXXXXXXXXXXXXXXXXXXX-XXXXXXXXXXXXXXXXXXXXXXXXXXXXXXXXXXXXXXXXXXXXXXXXXXXXXXXXXXXXXXXXXXXXXXXXXXXXXXXXXXXX---XXXXXXXXXXXXXXXXXXXXXXXXXXXXXXXXXXXXXXXXXXXXXXXXXXXXXXXXXXXXXXXXXXXXXXXXXXXXXXXXX--XXXXXXXXXXXXXXXXXXXXXXXXXX-XXXXXXXXXXXXXXXXXXXXXXXXXXXXXXXXXXXXXXXXXXXXXXXXXXXXXXXXXXXXXXXXXXXXXXXXXXXXXXXXXXXXXXXXXXXXXXXXXXXXXXXXXXXXXXXXXXXXXXXXXXXXXXXXXXXXXXXXXXXXXXXXXXXXXXXXX--XXXXXXXXXX--XXXXXXXXXXXXXX---XXXXXXXXXXXXXXXXXXXXXXXXXXXXXXXXXXXXXX--XXXXXXXXXXXXXXXXXXXXXXXXXXX-XXXXXXXXXXXX-XXXXXXXXXXXXXXXXXXXXXXXXXXXX----XXXXXXXXXXXXXXXXXXXXXXXXXXX--XX--XXXXXXXXXXXXXXXXXXXXXXXXXXXXXXXXXXXXXXXXXXXXXXXXXXXXXXXXXXXXXXXXXXXXXXXXXXXXXXXXXXXXXXXXX-XXXXXXXXXXXX-XXXXXXXXXXXXXXXXXXXXXXXXXXXXXXXXXXXXXXXXXXXXXXXXXXXXXXXXXXXXXXXXXXXXXXXXXXXXXXXXXXXXXXXXXXXXXXXXXXXXXXXXXXXXXXXXXXXXXXXXXXXXXXXXXXXXXXXXXXXX
