---------------------------------------------------------------------------------------------------------------------------------------------------------------------------------------------------------------------------------------------------------------------------------------------------------------------------------------------------------------------------------------------------------------------------------------------------------------------------------------------------------------------------------------------------------------------------------------------------------------------X----------------------------------------------------------------------------------------------------------------------------------------------------------------------------------------------------------------------------------------------------------------------------------------------------------------------------------------------------------------------------------------------------------------------------------------------------------------------------------------------------------------------------------------------------------------------------------------------------------------------------------------------------------------------------------------------------------------------------------------------------------------------------------------------------------------------------------
--------------------------------------------------------------------------------------------------------------------------------------------------------------------------------------------------------------------------------------------------------------------------------------------------------------------------------------------------------------------------------------------------------------------------------------------------------------------------------------------------------------------------------------------------------------------------------------------------------------------------------------------------------------------------------------------------------------------------------------------------------------------------------------------------------------------------------------------------------------------------------------------------------------------------------------------------------------------------------------------------------------------------------------------------------------------------------------------------------------------------------------------------------------------------------------------------------------------------------------------------------------------------------------------------------------------------------------------------------------------------------------------------------------------------------------------------------
SSSSSSSSSSSSSS--------------SSSS----------------------oo---------------------------------------ooo------------------------------------------------------------SS--------------------------------------------------SSSSSSSSSSSSSS------------oo-----------------SSS-------------------------SS----------SSSSSSSSSSSSS------------ooSSSSS---SS----------------------SS------------S-------------SS--------SSS-SSSSSSSSSS------------------S---------------------oo---------------SSSSS-----------------------------------------------------------------------------o--------------------o?--oooo---------------------?---ooo------------oo----SSS?--oooS----SS--------------------ooSSSSSS--SS----------------------------------SSSS--------------------------------------SSSS------------------------------------SSSSSSSSSSSSSS----------------------------SSSSSS------------SS---------------?----oo-----------------SSS------------S-SSSSSSSS---SS------------SS-------------------------SSSS--------------o----ooo--------------SS-SSSSSSSSSSS------------o-SSSSSSSSSSSSSS------------------------------SSSS--------------------------S---------SS------SSSSSS--------------------------------SS--------SSSSSSSSSSSSSS------------o-------------------------------------------------------o-SS-SSS--SSS--S------------oo------------------SS---------------------------------ooo-------------------------------SSS-------------------ooo--------------
------S-------------------------------------------------------------------------------------------------------------------------------------------------------S-------------------------------------------------------SS---------------------------------------SS--------------------------SS--------------------------------------SS-S--------------------------SSS------------S------------SS--------------------------------------------------------------------------------SSSSS---------------------------------------------------------------------------------------------------------------------------------------------------------------------SSS----------------------SSSSSS---S----------------------------------SSS---------------------------------------SSS--------------------------------------------------------------------------------SSSS------------------------------------------------------SSS------------------------------------------------------------------SSSS--------------------------------------------------------------------SS---------------------------------------SSS----------------------------------------------------------------------------------S----------SSSSS--S-------------------------------o-----------------------------------------------S-----------------------------------------S--------------------------------------------------------------------SSS------------------------------------
--?---S--------------------------S-----------------------oooo----------------------------------------------------------------------------------S-------------SS----oo---ooooo--oooo------S-----oo-----oo---oooo-------SS-------------------------------------?-SS---------ooooo----------S-SS--------------------------------------SSSS--------------------------SSS---o--------S----------?-SS----oo----------------------------------SS-----o-------------------oo----------oSSSSS---o----------------------------------------------------------------------------o----------------------------------oo-----------------o----------------------------S-SSS---oo-----------------oSSSSS---S----oo--------------------------oSSSS------------------oo---o-oo-----oo---oSSSS-----E------------o------------------------------------------------oo----------oSSSSS---------?-SS-------------------------------------oS-SSS---o-----------------------------------SS-----------------------oSSSSS---oo---------------------------------------------o-----------------SS-------------------------------------SSSSS--------o-ooo----oo---------------------------------ooo---ooo--------------------SS----oo---SSSSSS-SS------------------------------------SS----o------------------------------------S----------------------------------------SS----oo------------oo-------------------------------o--------------E-SSS----o--------------------------oo---
-----S-----------------------SSSSSSSS--------------------SSSSS--------------------------------------------------------------------------Q--------------------S-----XX--------------------------XX------------X----------------------------------------------S------------------------------------------------------------------------------S---------------------------XX------------XX------------XX-----------------------------------------X---------------SS-----------------------SX--------------SSS----------------------------------------------------------------------------------------------X------------------------------------------------SS----XX--------------------------SX----------------------------------------XX------------XX------------X----S--SS----SX------------XX--------------SSS---------ooooo-------------------------------------SX------------------------------------------SSS---------XX------------------------------------------------------S?SSSS--SS----XX----------------------------------------------------------------------------------XX-------------X------------S-----------------------------------------------------------------------SSS---------XX---------S--S---------------------------S-SSS---------XX------------------------------------------Q---------------------------------------XX------------XX-----------------S-SSS----SSS-------------SSSS--SS----SX--------------------------XX---
------------------------------------------------------------------------------------------------------------------------------------------------------------------------------------------------------------------------------------------------------------------------------------------------------------------------------------------------------------------------------------------------------------------------------------------------------------------------------------------------------------------------------------------------------------------------------------------------------------------------------------------------------------------------------------------------------------------------------------------------------------------------------------------------------------------XXXX--------------------------------------------------------------------------------------------------------------------------------------------------------------------------------------------------------------------------------------------------------------------------------------------------------------------------------------------------------XXX-----------------------------------------------------------------------------------o-----------------------------------------------------------------------------------------------------------------------------------------------------------------------------------
-SS-------------------------SSS---------------------------------------------------------------------------------------------------------------------------------------------------------------------------------------------------------------------------------------------------------------------------------------------------------------------------------------------------------------------------------------------------------------------------------------------------------------------------------------------------------------S---------------------------------------------------------------------------------------------------------------------------------------------------------------------------------------------------------------------------------------------------------------------------------------------------------------------------------------------------------------------------------------------------------------------------------------------------------------------------------------------------------------------------------------------------------------------------------------------------------------------------------------------------------------------------------------------------------------------------------------------------------------------------------------------------------------------------------------------------------------------------------------------------------
--S---------------SSSS--SSSS--oo----------------o---------------------------------------ooo-----------------------------------------SS----------SSSS--------ooooo-------------------------SSSS-----------------------o--ooo-----------ooo-----------------------SSSSSSSSSS------------------SSSSSSS--------------------------------------------------SSS--SSSS---ooooo----------oooo----------SSSS-------S----------------------oo------SSSS-------------------------SS----------ooooSS-------------------------oo----------------------------S-----------oo--------------------------------------SSS---------------------------------------------------oooo------------o-o----------oooo-S-------------------------ooo---------SSSSS-S-------SSo------------------------ooSS-SSSS-S----SSo---------------o------------------------SSS----------SSS------------ooo----------SSSS--S-SS-------o-----------------------ooooo------------ooo----------SSSSSSSS------SSSSSS-------------------ooooo---S--------------------------------------o-----------------------o--ooo---------oooo----------SSoo---------ooooo-----------SS-----------SSSSS-S----------oo------------------------------------oooo----------?------------------------------------------SSSS----------------------------------------------------oo--------------------------SSS-----------SSS---------------------------------------------------oooo-------------E------------So--------
-SSS-S-SSS-------------------SSSSSSSS----------------E--------------------------<>------S?S----E--------------------SS----<>-------------------------------------------------------------------------------------------??SS----------o---------------------------------------------------------------------o-----XX------------E-----------QQQ---------------------S--------------------------------------------SQQQ-----------------------------------------E--------------------------------------------------------------------------S----------------o--------------------------S?----XX---------------------------E-------------E------S?S----X-----SSS-------------o-----E----------SS---------------E----------------------------------------------------------------------------------------------------------------XX-------------------------------------------------------------------E-----------------------------------o-----E--------------------------------------------------------------S?----XX---------------------o-----XX-----------<>-------??SS------------------------------------------------------------------------------------Q------------------------------------------------------SQQQ------------<>---------------------------------S--------------------<>----------SQQQ-------------E------------------------------------------------SS----<>--X-SSSS--------------------------SS-----------SSSS----X----------------
----------------------------------------------------<>--------------------------[]------------<>--------------------------[]-------------------------------------------------------E---------------------------E---------------------------B--------------------------------------------------------------------XXX-----------<>----------------------------------------------------------------------------------------------------------------------------<>-------------------------------------------------------------------------------------------------B--------------------------XX--------------------------XX------------<>------------XX--------------------------<>--------------------------<>-----------------------------------------E----------------------------------------------------------------------X--------------------------------------------------------------------B-------------E---------------------------B--------------------------------------------------------------------XX---------------E-----------XX-----------[]-----------------------------------------------------------------------------------------------------------------------------E----------------------------------------[]-------------------------------------------E----------[]--------------------------<>------------------------------------------------------[]---------------------------E--------------------------XX-------------E--
----------------------------------------------------[]--------------------------[]------------[]--------------------------[]-----------------------------------------B------------<>--------------------------<>---------------------------b-------------------------------------------------------------------XXXX-----------[]-----------------------------------------B-----------------------------------------------------B----------------------------[]-------------------------------------------------------B-----------B-----------------------------b--------------------------XX---------------------------b------------[]------------XX-------------B------------[]--------------------------[]----------------------------------------<>------------<>--------------------------------------------------------X--------------------------------------------------------------------b-------------b---------------------------b--------------------------------------------------------------------XX---------------------------XX-----------[]---------------------------B---------------------------------------------------------------------------------------------------------------B--------------------------[]------------------------------------------------------[]--------------------------[]-----------------------------------------B------------[]--------------------------<>--------------------------XX------------<>--
------------XX--------------------------------------[]------E--E--E-----E-E-----[]------------[]----------EEE-------E-----[]------------E----------------------------b-----EE-E---[]-------------------EE-E---[]---------------------------B----------EE------------------------EE-E--------------------------XXXXX-----------[]----------------------E--E---------------b--------------------------------------------------E--b----------------------------[]-----------EE---------------------------E--------------b--------E--b------------E-E--------------B---------E-EE-----------XXXX-------------E-------------B------------[]------------XX-------------b------------[]--------------------------[]----------------------------------------[]------E-E---[]---------------------------E------------E---------------X-----------E------------E-------------------------------------------B-------------B---------------------------B---------------------------------------EE---------------------------XX--------E-EE---------------XX-----E-----[]---------------------------b-------------E----------------------E--E--------------------------------------EE-E--------------E--------------b--------------------------[]-----------EE-E------------E--------E-EE------E-E-----[]--------------------------[]----------EE---------------E-------------b------E-----[]-----E-------o------------[]-------------E------------XX-----E------[]--
XXXXXXXXXXXXXXXXXXXXXXXXXXXXXXXXXXXXXXXXXXXXXXXXXXXXXXXXXXXXXXXXXXXXXXXXXXXXXXXXXXXXXXXXXXXXXXXXXX--XXXXXXXXXXXXXXXXXXXXXXXXXXXXXXXXXXXXXXXXXXXXXXXXXXXXXXXXXXXXXXXXXXXXXXXXXXXXXXXXXXXXXXXXXXXXXXXXXXXXXXXXXXXXXXXXXXXXXXXXXXXXXXXXXXXXXXXXX-XXXXXXXXXXXXXXXXXXXXXXXXXXXXXXXXXXXXXXXXXXXXXXXXXXXXXXXXXXXXXXXXXXXXX--XXXXXXXXXXXXXXXXXXXXXXXXXX-XXXXXXXXXXXXXXXXXXXXXXXXXXXXXXXXXXXXXXXXXXXXXXXXXXXXXXXXXXXXXXXXXXXXX-XXXXXXXXXXXXXXXXXXXXXXXXXXXX---XXXXXXXXXXXXXXXXXXXXXXXXXXXXXXXXXXXXXXX-XXXXXXXXXXXXXXXXXXXXXXXXXXXXXXXXXXXXXXXXXXXXXXXXXXXXXXXXXXXXXXXXXXXXXXXXXXXXXXXXXXX-XXXXXXXXXXXX-XXXXXXXXXXXXXX--XXXXXXXXXXX-XXXXXXXXXXXXXXXXXXXXXXXXXXXXXXXXXXXXXXXXXXXXXXXXXXXXXXXXXXXXXXXXXXXXXXXXXXXXXXXXXXXXXXXXXXXXXXXXXXXXXXXXXXXXXXXXXXXXXXXXXXXXXXXXXXXXXXXXXXXXXXXXXXXXXXXXXXXXXXXXXXXXXXXXXXXXXXXXXXXXXX------XXXXXXXXXXXXXXXXXXXXXXXXXXXXXXXXXXXXXXXXXXXXXXXXXXXXXXXXXXXXXXXX--XXXXXXXXXXXXXXXXXXXXXXXXXXXXXXXXXXXXXXXX--X-XXXXXXXXXXXXXXXXXXXXXXXXXXXXXXXXXXXXXXXXXXXXXXXXXXXXXXXXXXXXXXXXXX-XXXXXXXXXXXXXXXXXXXXXXXXXXX--X-XXXXXXXXXXXXXXXXXXXXXXXXXXXXXXXXXXXXXXXXXXXXXXXXXXXXXXXXXXXXXXXXXXXXXXXXXXXXXXXXXXXXXXXXXXXXXXXXXXXXXXXXXXXXXXXXXXXXXXXXX-XXXXXXXXXXXXXX---XXXXXXXXXXXXXXXXXXXXXXXXXXXXXXXXXXXXXXXXXXXXXXXXXXXXX--XXXXXXXXXXXXXXXXXXXXXXXXXXXXXXXXXXXXXXXXXXXXXXXXXXXXXXXXXXXXXXXXXXX-XXXXXXXXXXXXXXXXXXXXXXXXXXXXXXXXXXXXXXXXXXXXXXXXXXXXXXXXXXXXXXXXXXXXXXXXXXXXXXXXXXXX--XXXXXXXXXXXXXXXXXXXXXXXXXX-XXXXXXXXXXXXXXXXXXXXXXXXXXX
