-------------------------------------------------------------------------------X-----------------------------------------------------------------------------------------------------------------------------------------------------------------------------------------------------------------------------------------------------------------------------------------------------------------------------------------------------------------------------------------------------------------------------------------------------------------------------------------------------------------------X------------------------------------------------------------------------------------------------------------------------------------------------------------------------------------------------------------------------------------------------------------------------------------------------------------------------------------------------------------------------------------------------------------------------------------------------------------------------------------------------------------------------------------------------------------------------------------------------------------------------------------------------------------------------------------------------------------------------------------------------------------------------------------------------------------------------------------------------
--------------------------------------------------------------------------------------------------------------------------------------------------------------------------------------------------------------------------------------------------------------------------------------------------------------------------------------------------------------------------------------------------------------------------------------------------------------------------------------------------------------------------------------------------------------------------------------------------------------------------------------------------------------------------------------------------------------------------------------------------------------------------------------------------------------------------------------------------------------------------------------------------------------------------------------------------------------------------------------------------------------------------------------------------------------------------------------------------------------------------------------------------------------------------------------------------------------------------------------------------------------------------------------------------------------------------------------------------------------------------------------------------------------------------------------------------------
SSSSSSSSSSSSSS--SSSS------------ES------------------------------------------o?---ooo---SS-------------------------------------------------ooSSSSSSSSSSSSSS------------------------------------------SSSSSSSSSSSSSS------------------SS--------------------------------------------------SS-SS---SSS--S-----------------SS--------------------------------------------------------o------------S---------------------------------------------------------------------S-----------------------SSSSSSSS--SS------E---------------------o-----------------------------------------------SS--------------S?--oooo--SSS--------------------------------------------------oSSSSSSSSSS------------------------------oo---------------SSSS---------------------------S---------------------oo-------------------------------SS---------SSSSSS------------SS--------------------------------------------------SSSSSS-----------SSS------------SS------oo--------------SSSSSS--SS----------------oo-------------------------------------------------------o-----------------------------------------oSSSSSS--------------------oo----------------------------------------------------------------------SSSSSSSSSS----------------ooSSSSSS--S-S---------------------ES-----------S-----------------------------S----------------------------------oo----------------------------S----S---------------------------------------------------SSSSS--SS-----------?----oo
------S--------SSSSS------------S------------------------------------------------------SS------------------------------------------------------------------------------------------------------------------------------------------SS-------------------------------------------------------S---------------------------S---------------------------------------------------------------------S---------------------------------------------------------------------S--------------------------------------------------------------------------------------------------------------SSS------------------------S-S----------------------------------------------------SSSSSSS-S-----------------------------------------------SSSS--------------------------SS-----------------------------------------------------SSS-------------SS-----------SS----------------------------------------------------S-SSS-----------SS-------------S------------------------SSSSS------------------------------------------------o------------------------------------------------------------------------SSSSS---------------------------------------------------------------------------------------------SSSSSSSSSS---------------------S---------------------------S--------------------------------------------------------------------------------------------------------------------------------------------------------------------SSSS---SS------------------
--?---S-------oSSSSS----E----E-S------E---oooo--oooo-------o-------------------------S-SS-----------------------oooooooo------------------------S-----------oo-----o----o-oo-----------------------------------------------------S-SS----oo-------------------------------------------------S-------------------------S-S---------------------------------------------------------------------S---------oooo-----oo---------------------------o---o--------------?-SS----oo------o-----oo----------------------------------------oo----------------------------------------------S-SSS---oo-----------------oSSSS------------S----------o---------------------------oSSSSSSS-S---------------------------oo-----------------oSSSS------------------------?-SS-----------------------ooooo--oooo------------------SSSS------------SSS--------o?-SS----oo---------------------------------------------oSSSSS---o-----?-SS-----------------------o-------------oSSSSS----------------------o-----------------------------oo---------------------------oo----oo------o-----oo-----------------oSSSSS---o----o------------------------------------o------------------ooooo---------ooooo---ooo---SSSSSSSSSSS---------------------S--------------------------S-----oo-----SS-------------------------------------------------------------oo---o----------------o----ooo-----------------------------------------------------------oSSSS---SS------------------
-----S--------S-SSSS--SS----S-SSSS---SSS----------o--------------------------------S---------SX---XXX--------SSS----------------------------------S------------------------------------------------------------------------S?SSS---S-----XX-----------------------------------------QQQ----------S-Q-------------------------S-----------------------------------------------XX----------S---------S?-------------------------------S---------S--------------SSS---------XX------------XX----------------------------------------XX--------------------SQQ-----------S-----?X------SS----XX--------------------------SQS------------X---XX---------SSS----------------SSSS--S?---------------------------XX--------------------------S----------------------------X------------------------------------------SSS---------SQ------SSS---?-------------XX---S-------------------S-S-----------------S----S-----XX---S----------------------?---------------SSS---------S-----------------------------------------S?SSS-------------------------------------XX------------XX--------------------SSS---XX----------------------------------------XX-----------------------------------------------SSSS--SXX--------------------------S-------------XX---S--SS----XX-----------SS--------------?SSS---SSQ-------------------------------?X--------------SSS---------XX---E---------ooo------------SSS----------?-----------------S--SS---SS------------------
--------------------------------------------------------------------------------------------------X-------------------------------------------------------------------------------------------------------------------------------------------------------------------------------------------------------------------------------------------------------------------------------------------------------------------------------------------------------------------------------------------------------------------------------------------------------------------------------------------------------------------------------------X--------------------------------------------------------------------------------------------------------------------------------------------------------------------------------------------------------------------------------oo---------------------------------------------------------------------------------------------------------------------------XXo-------------------------------------------------------------------------------------------------------------------------------------------------------------------------------------------------------------------------------------------------------------------------------------------------------------------------------X---------------------------XXXXXX--------X---------------------------------------------------------------------
-SS-------------------S-------------------------------------------------------------------------------------------------------------------------------------------------------------------------------------------------------------------------------------------------------------------------------------------------------------------------------------------------------------------------------------------------------------------------------------------------------------------------------------------------------------------------------------------------------------------------------------------------------------------------------------------------------------------------------------------------------------S-----------------------------------------------------------------------------------------------------------------------------------XXXXX-o-----------------------------------------------------------------------------------------------------------------------------------------------------------------------------------------------------------------------------------------------------------------------------------------------------------------------------------------------------------------------------------------------------------------------------------------------------------------------------------------------------------------------------------------------------S-------------------
--S--------------ooo--SSS-------So--------------------------SSSS------------------------oooS------------------------------------------------SS-?--------------SSS--------------------------SSSS-S---------ooo----------------------oooo--------------------------SS----------------------S----------------------------------------------oo----------oooo----------------SSSS--------------------ooo----------S--------------------------SS----SSSS------------------SSSS----------SSS-------------------------SSSSSSSSSS----oo------------SSSS--S-----E-------------oooo----------ooooo---------------------------------------SSSS--------------------------ooo-------oooooo------------oo----------ooo---------------S----------S--SS--------SSSS--SSSS----SSSS----------------------------------------ooo----------SS-S-------ooooo----------oooo------------------oX-------------------------------oooooo----------SSSS--S------ooooo-----------------------o-oooo----------------------------------------------------SS-------------ooo---------SSS-----------SSS-------------oo--------oooooo--------------------------------------oooo--------------------------------------------------ooooooo---------ooo----------?---o----------oooo--------oooo-----------------------------oo-------oo-E------------SSSS--SSSS--oooo--------------------------SS-----------------------------------------ooo-----------SS------------S--SSS----------oo-----
-SSS-S-SSS-------SS-----S---------------S------------E--------------------------XX---------------------------E-------------E-------------E----------SQQQQ------------------------------------------------o?S-----------------------------------------------------------------------QQQ----------SQQQQ------------------------QQ-------------------------------------------------------XX-----------------------------------------------------------------------------------------------------??SSSSS-------------------------------E------------------SSSSSS---------SSS------------SS-------------------XX----------SQ----------------------------E-------o---------??SSSSSS---------------------------------------------------------------------------------------------------<>---------------------------------------------??SSSSS---------------------------------------------QQQ-------------------S--------------------------S?S----E-----------------------------------------E-----------------------------S-------------------o----------------------------------------------------?--SSS-----------------E------SS-----E-----------------------------------------------------------?SSSSSSSS---------?-----E----------SQQ--------------------SSS------------------QQ-----------------??SSSSS------------------------SS-----E------------------------------------------SS--------------------------------------------SSS----SS--------------E--
----------------------------------------------------<>--------------------------XX--------------------------<>------------<>------------<>---------------------------------------------------------------------X----------------------------------------------------------------------------------------------------------------------------------------------------------------------XX---------------------------------------------------------------------------------------------------------------XX-------------------------<>-----------------------------------------E--------------------------XXX---------------------------------------<>-------------------------------------------------------E--------------------------------------------------------------------[]-------------E------------------------------------------------------------------------------------------------------------------------------------------<>-------------E--------------------------<>-------------E-----------------------------------------------------------------------------------E--------------------------<>------------<>-----------------------------------------E----------------------------------------<>-----------------------------------------------------------------------------------X--------------------------<>-------------------------------------------------------E-------------------------------------------------------B--
----------------------------------------------------[]--------------------------XX--------------------------[]------------[]------------[]---------------------------------------------------------------------XX----------------------------------------------------------------------------------------------------------------------------B-------------B------------------------X-XX-------------------------------------------------------------------------------------------------B------------XXX-------------------------[]--------------------------X-------------<>-------------B------------XXX---------------------------------------[]-----------------------------------------b------------<>--------------------------------------------------------------------[]------------<>-----------------------------------------X------------------------------------------------------------------------------------------------[]------------<>--------------------------[]------------<>-----------------------------------------------------------------------------------B--------------------------[]------------[]-------------B--------------------------<>----------------------------------------[]---------------------------B-------------B----------------------------------------XX--------------------------[]------------------------------------------------------<>-------------------------------------------------------b--
------------XX-------------------------------EE-E---[]-E----------------------X-XX--------------------------[]----E-E--E--[]-E----------[]----------------------E--E-----------E-EE-----------------------------X-----------E--------------E---------E-EE------------EE---------------------------------------EEE----------------------------b-------------b--------E---------E----XX-XX--------------------------EE--------EEEE-------E-------E------------E----------------------------b------------XXX-------------------------[]--------------------------XX------------[]-------------b----------X-XXX---------E-E---------------------------[]---------------------------o--------------------------[]----------E-E-----------E-----------E-------------------------------[]------E-E---[]--------------------------E--------------X-------------E-----E-------E--------------------------E--------------E--------------------------[]------------[]--------------------------[]------------[]-----------EE-E----------E-----------------------------E-------------E-------------b-------------E------------[]-----EE-----[]-------------b----------EEE-------E--E--[]------E-EE-E-E--------------------------[]---------------------------b-------------b----------E-E---------------------------XX--------------------------[]------------E------E-------E--------------------------[]--------------------------E----------------------------B--
XXXXXXXXXXXXXXXXXXXXXXXXXXXXXXXXXXXXXXXXXXXXXXXXXXXXXXXXXXXXXXXXXXXXXX--XXXXXXXXXXX-XXXXXXXXXXXXXX---XXXXXXXXXXXXXXXXXXXXXXXXX-XXXXXXXXXXXXXXXXXXXXXXXXXXXXXXXXXXXXXXXXXXXXXXXXXXXXXXXXXXXXXXXXXXXXXXXXXXXXXXXXXXXXXXXXXXXXXXXX-XXXXXXXXXXXXXXXXXXXXXXXXXXXXXXXXXXXXXXXXXXXXXXXXXXXXXXX-XXXXXXXXXXXXX-XXXXXXXXXXXXX-XXXXXXXXXXXXXXXXXXXXXXXXXXXXXXXXXXXXXXXXXXXXXXXXXXXXXXXX-XXXXXXXXXXX-XXXXXXXXXXXXXX-XXXXXXXXXXXXXXXXXXXXXXXXXXXXXXXXXXXXXXXXXXXXXXXXXXXXXXXXXXXXXXXXXXXXXXXXXXXXXXXXXXXXXXXXXXXXXXXXXXXXXXXXXXXXXXXXXXXXXXXXXXXXXXXXXXXXXXXXXXXXXXXXXXXXXXXXXXXXXXXXXXXXXXXXXXXXXXXXXXXXXX--XXXXXXXXXXX-XXXXXXXXXXXXX-XXXXXXXXXXXXXX--XXXXXXXXXXXX-XXXXXXXXXXXX-XXXXXXXXXXXXXXXXXXXXXXXXXXXXXXXXXXXXXXXXXXXXXXXXXXXXXXXXXXXXXXXXXXXXXXXXXXXXXXXXXXXXXXXXXXXXXXXXXX--XXXXXXXXXXXXXXXXXXXXXXXXXXXXXXXXXXXXXXXXXXXXXXXXXXXXXXXXXXXXXXXXXXXXXXXXXXXXXXXXXXXXXXXXXXXXXXXXXXXXXXXXXXXXXXXXXXXXXXXXXXXXXXXXXXXXXXXXXXXXXXXXXXXXXXXX-XXXXXXXXXXXXX-XXXXXXXXXXXXXXXXXXXXXXXXXXX--XXXXXXXXXXXXXXXXXXXXXXXXXX--XXXXXXXXXXXXXXXXXXXXXXXXXXXXXXXXXXXXXXX-XXXXXXXXXXXXXXXXXXXXXXXXXXXXXXXXXXXXXXXXXXXXXXXXXXXXXXXXXXXXXXXXXXXXXXXXXXXXXXXXXXXXXXXXXXXXXXXXXXXXXXXXXXXXXXXXXXXXXXXXXXXXXXXXXXXXXXXXXXXXXXXXXXXXXXXXXXXXXXXXXXXXXXXXXXXXXXXXXXXXX-XXXXXXXXXXXXXXXXXXXXXXXXXXXXXXXXXXXXXXXXXXXXXXXXXXXXXXX-XXXXXXXXXXXXXXXXXXXXXXXXXXXXXXXXXXXXXXXXXX--XXXXXXXXXXXXXXXXXXXXXXXXXX------XXXXXXXX--XXXXXXXXXXXXXXXXXXXXXXXXXXXXXXXXXXXXXXXXXXXXXXXXXXXXXX--XXXXXXXXXXX-
