--------------------------------------------------------------------------------------------------------------------------------------------------------------------------------------------------------------------------------------------------------------------------------------------------------------------------------------------------------------------------------------------------------------------------------------------------------------------------------------------------------------------------------------------------------------------------------------------------------------------------------------------------------------------------------------------------------------------------------------------------------------------------------------------------------------------------------------------------------------------------------------------------------------------------------------------------------------------------------------------------------------------------------------------------------------------------------------------------------------------------------------------------------------------------------------------------------------------------------------------------------------------------------------------------------------------------------------------------------------------------------------------------------------------------------------------------------
--------------------------------------------------------------------------------------------------------------------------------------------------------------------------------------------------------------------------------------------------------------------------------------------------------------------------------------------------------------------------------------------------------------------------------------------------------------------------------------------------------------------------------------------------------------------------------------------------------------------------------------------------------------------------------------------------------------------------------------------------------------------------------------------------------------------------------------------------------------------------------------------------------------------------------------------------------------------------------------------------------------------------------------------------------------------------------------------------------------------------------------------------------------------------------------------------------------------------------------------------------------------------------------------------------------------------------------------------------------------------------------------------------------------------------------------------------
SSSSSSSSSSSSSS----------------SSS--------------------------------------------------------------------------------SSSSS--S------------------------------------------------------------o-SSSSS--------SSSSSS--------------------------------------------------------------oo---SS----------SSSS---SS---------------------------------SSSSS---------------?----oo---------------------------------------------------------------?------------------------S-------------SS---------SSSSS------------SS----------------------SSS-SSSSSSSSSS-----------------SS-------------------------------------SSSSSSSSSSSSSS----S---------------------------E-------------E---------------------------------------------------------------o---------------SSSSSSSSSSSSSSSSSSS---SS--------------------------------------------------------oooo-------------------------------------------------------o----S---------SSSSSSSSSSSSSS-----------------SS-----------------------------------------SS------------------------------------------------ooSSSSSS--SSS--------------------------------------------------------ooo------------------------------SSS---E-----------------------------------------------------------------S-------------------------------------------------oo------------------------------SSSS-------------------------SSS----------------------------------oo--------------------------o---------------SSSSSS--------------------------S---------
------S-----------------------SSS--------------------------------------------------------------------------------SSSSS-----------------------------------------------------------------SSSSS----S----SSSSS------------------------------------------------o------------------------------SSSS--------------------------------------SSSSS--------------------------------------------------------------------------------------------------------------S------------SSS---------SSSSS------------SS------------------------------------------------------S--------------------------------------SSSSSSS----------------------------------------------------------------------------------------------------------------------------------o-------------------S-----------------------------------------------------------------------------------------------------------------------------S----------SSSSSSSS----------------------SS----------------------------------------SSS---------------------------------------------------S-SSS----------------------------------------------------------------------------------------------S---------------------------------------------------------------------------------------------------------------------------------------------------------SSS--------------------------SSS----------------------------------------------------------------------------------SS--------------------------S---------
--?---S-------o-oo-----------S-SS------------------------------------------------------------oo-----------------oSSSSS--S---------------------------ooo-------------------------------oSSSSS---SS---oSSSSS---S-------o-----------------------------------------------------S--S---------oSSSS---------ooo---oooo------------------oSSSSS-----------------------------oooo----------------------------------------------------------------------------SS----------E-SSS----E---oSSSSS-----------SS----oo------------oo---------------------------------SSS---------ooo-------------------------SSSSSSSS-------E-----------------------------S-----oo--------------------------oo-----------------o--------o------------------------------------------------SSS-------------o-------------------------ooo----------------------------------------------------------------------------------SS---------SSSSSSSS---------------------S-SS-------------------------------------oS-SSS---oo---o-----------------------------------------oSSSSS--------o----------------o-----oo-------------------------------------------------------------SSS---------------------------------------o----------------------------SS----oo-----------------o--o-----o----------------------------------------------oSSSS-----------------------oSSSSS---oo---------------------------------------------o----------------S-----oo------SSS--------o--------o-------SS---------
-----S---------------------------------------------S?SSS-------------------------------S-----XX------------S?SSSS-SSSSS-SS-----------------------------------------------------------SS-SSSS---SS------SSS--SXX------------------------------------------SSS-------------------------------------S------------o-------------------S-SSSSS-SS---------------------------------------------------------SSS--------------------------SS------------------------X---S-SSSSS-SSSS-----SS----SX------------XX------------------------------------------SSS----------------------o---------------------SSSSS--?----------------------------?-S----------XX---S----------------------XX--------------------------X-----------------------------SSS-----------------------S---------------------------------------------------------------------S?SSS-SS------------------------------------------------XX-------SSS------------------------------SX----------------------------------S-----XX--------------SSS-----------------------XX------------S---------------SSS---------X------------------------------------------?SSS----------------------SS--------------X------------------------------------------------------XX-------------X--------------------------------------------------------------------S--------------?-S----S-----XX----------------------------------------SQSQ---------o--------------XX------S-S---?------------o---------------X---
------------------------------------------------------------------------o-----------------------------------------------------------------------------------------------------------------------------------------------------------------------------------------------------------------------------------------------------------------------------------------------------------------XXXXX-----------------------------------------------------------------------------------------------------------------------------------------------------------------------------------------------------------------------------------------------------------------------------------------------------------------------------XXX-------------------------------------------------------------------------------------------------------------------------------------------------------------------------------------------------------------------------------------------------------------------------------------------------------------------------------------------------------------------------------------------------------------------------------------------------------------------------------------------------------------------------------------------------------------------------------------------------------------------------------------------------------------------------------------------------------------------------
-SS---------------------------------S-----------------------------------------o-----------------------------------------S---------------------------------------------------------------------------------------------------------------------------------------------------------S-------------------------------------------------------S-------------------------------------------------------------------------------------------------------------------------------------------S-----------------------------------------------------------------------------------------------------------------------------------------------------------------------------------------------------------------------------------------------------------------------------------------------------------------------------------------------------------------------------------------------------------------------------------------------------------------------------------------------------------------------------------------------------------------------------------------------------------------------------------------------------o-----------------------------------------------------------------------------------------------------------------------------------------------------------------------------------------------------------------------------------------------------------------------------------------------------------
--S---------------------------------SSS---------------------------SSSS------------------S-----------------o---------oo--SSS---------SSSSS-------S-----------------------------oo--------ooooo---------oooooo----------SSS------------SSSS-------------------------o--------------SSSS------------------------------------SSS----------oo--SSS---------ooo-----------------------SSSSS-SSSS--------o-------------S------------oo------------S--ooo-----SSSS---------ooo-----------oooo-SSS-----ooooo-----------SSS---SSSS------oo-------------------------SS-------------------------SSSS--SSSS--ooooooo---------SSS-SSSSSS------oo----------SSS-----------SSS-SSSSSS----SSS---------------------------------------------------------------SS-?------------------------------------------------ooo-------------------ooo-------------------------------------------------------o-----------oooo---------???------------SSSSS---------oooo----------oooo----------------------ooooo---------------------------S-----------oo-----------oooooo-----------------------SS---------------------------------------------------------SSSSS---------------------SSS--------------------------------------SSSS--SS------SSS------------oo-----------SS---------------------------SSSS-------------S---------SSS-SSS--------SSo---------ooooo--------------------------oo--------------------------------------SSS---------oooooo------------------------SSSS------
-SSS-S-SSS--------------------SS--------------------------------------------------------SS-----------------Q-------SS----SSS-----------------------------------------E-------------------SSS----S----??SSSSS-------------------------------------------------------------------------------------QQQ-------------E-------------------SS----SSS-------o------------------------------------------------SS--------------------------S---------------------------------S-----SSS--------------------S---------------------------o?SS--------------------------------------------E-----------------??SSSSSSS-------------------------------------------------------------------------------------E-------------E------------<>---------------S----------QQ----------SQQQ-------------------------------------------------??----E-----------Q-------------------------------------------------------------?o--E?SSQQ----------------------------------------------------------------------------------------------------------------E----o--??SSQ--------------------------------------------------------<>--------------------------------SS--------------------------ESSSS----X-----------------------------------------------------------------------------------E-------------------------------------------------------------------------------------------o?----------------QQQ-Q-----------E-----------------??SSSSS-----------------E----------------
-----------------------------------------------------------------------------------------------E-------------------------------------------------------E------------<>-------------E-----------------------------------------------------------------------------------E----------------------------------------<>-----------------------------------------B-------------------------------------------------------------------------------------------------------------------------------------------E-----------------------------------------E--------------------------<>--------------------------------------------------------------------------------------------------------------<>------------<>------------[]--------------------E---------------------------------------------------------------------------<>-------------------------------------------------------E---------------------------------------------------------------------E--------------------------------------------------------------------<>---------------------------E-------------E--------------------------[]--------------------------------------------------------------------XX-------------------------------------------------------E---------------------------B-------------------------------------------------------------------------------------------------B--------------------------<>----------------------------------------<>----------------
-----------------------------------------------------------------B----------------------------<>------------------------------------------------------<>------------[]-------------E----------------------------------------------------------------------------------<>----------------------------------------[]-----------------------------------------b------------------------------------------S--------------------------------------B---------------------------------------------------------B----------------------------------------<>--------------------------[]--------------------------------------------------------------------------------------------------------------[]------------[]------------[]-------------------------------------------------------------------B----------------------------[]-------------------------------------------------------B---------------------------------------------------------------------B--------------------------------------------------------------------[]--------------------------<>------------<>--------------------------[]--------------------------------------------------------------------XX-------------------------------------------------------B---------------------------b-------------------------------------------------------------------------------------------------b--------------------------[]---------------------------X------------[]----------------
------------XX-------E-EE--------------------------EE---------E--b------------EEE------E------[]------------E-------------------------E--------EE-E---[]------------[]-------------B---------------------------E-----------E-------------E-------------EE-E-----------[]---------------------------------EE-E---[]-E---------EE----------------------------------EE-E--E-E--------E-----------------------------E-E-----------------------E--b---------------------------------------------------------b--------E-------------------------------[]-------------------EE-----[]----------------------------X----------------------------------------E---------------------------E------E-----[]------------[]------E-----[]------------E-E------------------------------------E-E----------E--b----------EE-E--------------[]-----------------------E-EE-E-------E-EE--------------Eb---------------------------------------------------------------------b----------EEE--------------E------------E-------------E-------------[]--------------------------[]------------[]--------E-EE--------------[]------------E---------E--E------------E-E-------------E-------------XX--------EE-E----------E------------------E------------Eb------------EE-------------B----------E-------------E-E---------------------------E--------------E----------EEE--------------B--------------------E-----[]-------------E-------------XX-----E-----[]----------------
XXXXXXXXXXXXXXXXXXXXXXXXXXXXXXXXXXXXXXXXXX-XXXXXXXXXXXXXXXXXXXXXXXXXXXXXXXXXXXXXXXXXXXXXXXXXXXXXXXXXXXXXXXXXXXX-XXXXXXXXXXXXXXXXXXXXXXXXXXXXXXXXXXXXXXXXXX-XXXXXXXXXXXXXXXXXXXXXXXXXXXXXXXXXXXXXXXXXXXXXXXXXXXXXXXXXXXXXXXXXXXXXXXXXXXXXXXXXXX---XXXXXXXXXXXXXXXXXXXXXXXXXXXXXXXXXXXXXXXXXXXXXXXXXXXX-XXXXXXXXXXXXXXXXXXXXXXXXXXXXXXXXXXXXXXXXXXXXXXXXXXXXXXX-XXXXXXXXXXXXXXXXXXXXXXXXXXXX-----XXXXXXXXXXXXXXXXXXXXXXX--XXXXXXXXXXX-XXXXXXXXXXXXXXXXXXXXXXXXXXXXXXXXXXXXXXXXXXXXXXXXXXXXXXXXXXXXXXXXXXXXXXXXXXXXXXXXXXXXXXXXXXXXXXXXXXXXXXXXXXXXXXXXXXXXXXXXXXXXXXXXXXXXXXXXXXXXXXXXXXXXXXXXXXXXXXXXXXXXXXXXXXXXXXXXXXXXXXXXXXXXXXXXXXXXXXXXXXXXXXXXXXXXXXXXXXXXXXXXXXXXXXXXXXXXXXXXXXXXXXXXXXXXXXXXXXXXXXXXXXXXXXXXXXXXXXXX--XXXXXXXXXXXXXXXXXXXXXXXXXXXXXXXXXXXXXXX-XXXXXXXXXXXXXXXXXXXXXXXXXXXXXXXXXXXXXXXXXXXXXXXXXXXXXXXXXXXXXXXXXXXXX-XXXXXXXXXXXXXXXXXXXXXXXXXXXXXXXXXXXXXXXXXXXXXXXXXXXXXXXXXXXXXXXXXXXXXXXXXXXXXXXXXXXXXXXXXXXXXXXXXXXXXXXXXXXXXXXXXXXXXXXXXXXXXXXXXXXXXXXXXXXX-XXXXXXXXXXXXXXXXXXXXXXXXXXXXXXXXXXXXXXXXXXXXXXXXXXXXXXX--XXXXXXXXXXXXXXXXXXXXXXXXXXXXXXXXXXXXXXXXXXXXXXXXXXXXXXXXXXXXXXXXXXXXXXXXXXXXXXXXXXXXXXXXXXXXXXXXXXXXXXXXXXXXXXXXXXXXXXXXX--XXXXXXXXXXXXXXXXXXXXXXXXXXXXXXXXXXXXXXXXXXXXXXXXXXXXXXXXXXXXXXXXXXXXXXX-XXXXXXXXXXXXXXXXXXXXXXXXXXXXXXXXXXXXXXXX-XXXXXXXXXXXXXXXXXXXXXXXXXXXXXXXXXXXXXXXXXXXXXXXXXXXXXXXXXXXXXXXXXXXXXXXXXXXXXXXXXXX-XXXXXXXXXXXXXXXXXXXXXXXXXXXXXXXXXXXXXXXXXXXXXXXXXXXXXXXXXXXXXXXXXXXXXX
