--------------------------------------------------------------------------------------------------------------------------------------------------------------------------------------------------------------------------------------------------------------------------------------------------------------------------------------------------------------------------------------------------------------------------------------------------------------------------------------------------------------------------------------------------------------------------------------------------------------------------------------------------------------------------------------------------------------------------------------------------------------------------------------------------------------------------------------------------------------------------------------------------------------------------------------------------------------------------------------------------------------------------------------------------------------------------------------------------------------------------------------------------------------------------------------------------------------------------------------------------------------------------------------------------------------------------------------------------------------------------------------------------------------------------------------------------------
--------------------------------------------------------------------------------------------------------------------------------------------------------------------------------------------------------------------------------------------------------------------------------------------------------------------------------------------------------------------------------------------------------------------------------------------------------------------------------------------------------------------------------------------------------------------------------------------------------------------------------------------------------------------------------------------------------------------------------------------------------------------------------------------------------------------------------------------------------------------------------------------------------------------------------------------------------------------------------------------------------------------------------------------------------------------------------------------------------------------------------------------------------------------------------------------------------------------------------------------------------------------------------------------------------------------------------------------------------------------------------------------------------------------------------------------------------
SSSSSSSSSSSSSS--------------SSSSSSSSSSSSSS----------------------------------------------------------------------------------------SS--------------------------------------------------SSSSSS----------------------------------o---------------------------------------------------------------------------------------------------SS--SSS----ooo---------------------------------------------------------------------o--SS------------------------------------o-----------------------------------------------------------------------------------------------------SSSS-----------------------SSSSS----------------------------------oo------------------------------------------SSSSSSSSS-SSSS------------o--SSSSS--------------------------S-------------S-----------------------SSSSSS------------ES----------------------------------------S-------------------------------------------------oo--------------------------------------------------------------------o-------------------SS----------------------SS-SSS------------------------------------SSSSSS------oo--------------------------------------------------------SSSSSS-SSSS--S----S----------------------o----------------------------------------------------------------------------------ooSSSSSSSSSSSSSS--------------------------o---SSSS--------------------oo------------oo--------------------------oo------------------------oooo----------------SSSS-------------SSS--oooS
------S---------------------------------------------------------------------------------------------------------------------------S----------------------------------------------------SSSSS-S-SS-------------------------------------------------------------------------------------------------------------------------------------SS----------------------------------------S---------------------------------------------------------------------------------------------------------------S-------------------------------------------------------------------SSS------------------------SSSSS--------------------------------------------------------------------S-------------SS-----------------------SSSSS--------------------------S-------------S------------------------SSSSSSSSSS-------S-----------------------------------------SS---------------------------------------------------------------------------------------------------------------------------------------------------------------------SSS---------------------------------------SSS-----------------------------------------------------------------SSSS---S---------S------------------------------------------------------------------------------------------------------------SSSSSSSSS----------------------S-----------SSS-------------S----------------------------------------------------------------------------------------------SSSSS----------------------
--?---S-----------------------------------ooooo--ooo---------------------------------------------------------------------------?-SS----oo---o------------------------------o-----oo---oSSSSS-SSSS---------------------------o-------------------------------o-----------------------------------------------------------------------------------oooo-------------o--------------S---------------------------------------------------ooooo----o----o------------------------------------oo------S-----oo-----------------ooooo----o------ooo----oo-----------------oSSSS------------------o----oSSSSS---o----o----------------------------------------------------------S---------------S----------------------oSSSSS---o-------o-----oo------S-----oo-------S-----------------------oSSSSS-SSSS------S------o------------oo---oo----------------S-----------------------o-----oo----------------------oo--------------------------oo------------------------------------------------------------------o----------------SSS---o----o-oo-------------------oo----S-SSS----------------------------------------------------------------SSSSS---S--------SS----o---------------------S-----oo-------------------ooo-ooooo---------------------------------------------SSSSSSSSS----------------------S-----oo---oSSSS-----------------------------------------------------------------------------------------------------------oSSSSS---o------------------
-----S---------------------------------------------------------------------------------------------------------------------------------XX-----------o----------------------------XX-----SSSS--SXX--------------------------?X--------------SSS---------S-----------------------------------------------------------S-----------------------------------------------------------------SQ---------------------------X--------SSQ----------------------------------S-Q?S-----S------------XX------------XX----------------------------------------------------------------------------------XX------S-----SX---------------S------------------------S?SSS-----------------SS----XX------------------------------SS--SS----SX------------XX------S-----XX------------XX-----------------SSSSSSSSSSS---S--S------X------------XX-----------o--------------?-------SS----XX-------------------------------------------------------?SSS-----------------------S?SSS------------------------------------------XSSS-------SSS---------X----------------------------X------S-----?-------------S?SSS--------------------------------------------------SS-------------XX--------------------------XX-----------------------------------------------------------------------------SSS--S-------------S?------S-----XX------------S-------------?X-----------------S--SS----SS---------------------------Q----------------------------------------XX-----------------
------------------------------------------------------------------------------------------------------------------------------------------------------------------------------------------------------------------------------------------------------------------------------------------------------------------------------------------------------------------------------------------------------------------------------------------------------------------------------------------------------------------------------------------------------------------------------------------------------------------------------------------o-----------------------------------------------------------------------------------------------------------------------------------------------------------------------------------------------------------------------------------------------------------------------XXXX------------------------ooo-------------------------------------------------------------------------------------------------------------------------------------------------------------------------------------------------------------------------------------------------------------------------------------------------------------------------------------------------------------------------------------------------------------------------------------------------------------------------------------------------------
-SS-------------------S-----------------------------------------S---------------------------------------------------------------------------------------------------------------------------------------------------------------------------------------------------------------------------------------------------------------------------------------------------------------------------------------------------------------------------------------------------------------------------------------------------------------------------------------------------------------------------------------------------------------------------------------------------------------------------------------------------------------------------------------------------------------------------------------------------------------------------------------------------------------------------------------------------------------------------------------------------------------------------------------------------------------------------------------------------------------------------------------------------------------------------------------------------------------------------------------------------------------------------------------------------------------------------------------------------------------------------------------------------------------------------------------------------------------------------------------
--S-------------------S?-----------o---------------------------SSSS-------------------------------------S------------------------oSoo--------------------------SS-----------SSS---------ooooooo-----------------------oo------------------------------S-----------------------SSSS---------------------------------------------------ooooo-----------S------------SSS---------------S----------SSS-----------ooo--------Q---------------------------------------------------------SSS----------oooo------------SSSS-SSSS-------------------SS-------------ooo---------SSSSSSS-------SSS----------oooooo-----------------------------------------------------ooo-------oooo-----------ooooo-----------------------oooo-S-S-------SSS---------oooo------------oooo----------SSSSSSSSSS--ooooo-----------SS----SSSS----So-------------------------ooooo----------oo--------------------------ooo-------------S---------------o-----------S---------------------------------------SSSS--oo------SSSS--S--------------------ooooo------------------------SSSS--S-----oooooo------------------------------oo---------------------SS------------------------oooo-------------oo----------SSS---------------------------------------------ooo-----------ooo------------------???-------------SSS--------oooo------------SSSSSSS------oooo--------------oo-----------------------------------------S-----------------------SSSS---------oooooS-------------------
-SSS-S-SSS-----------------------o-----XX------------------S-------------------------------------------------------------------------------------------E--------------------------------SSSSS-SS----------------------SS-----E--------------------------------------------------------------------------------------------------------S?SS-----------------------------------------------------------------------------??SSSSSS------------------------------E--SSS-S--------------------------------------------------------------------------------------------------------------------------------------------------------------------------------------------------SSS---------??SSSSSS---------------<>---------------------------------SSS-------------?-----------------------SSSSS---SS----------------------------E-------------E-------??----------SSS-------------------E-------------E-------------------------Q---S-----------------------Q---Q---SSSS---XX-------------------------------------------------??S------------------------------------?SSSSS--------------------------------------SS-----E------------------------SSQQ---------------------------------------------------------------------------------------------------------------E----o--E-SSQQQ--------------------SS-----E---------------------?S----E-------------E-----SSS-------------------E---------------------?-----E-----------------------------------o-----XX-
---------------------------------------XX----------------------------E--------------------------------------------------------------------------------<>--------------------------------------------------------------------<>-----------------------------------------E---------------------------------------------------------------------X---------------------------------------------------------------------E--------------XX------------------------<>---------------------------E---------------------------------------------------------------------B---------------------------------------------------------------------E--------------------------------------------------------X-----------[]-----------------------------------------E-------------E------------------------------------------------------<>------------<>---------------------------E------------<>------------<>--------------------------------------------------------------------XX------------------------------------------------------------------------------------------------------------------------------------------<>------------------------------------------------------------------------------------------------------------------------------------------<>----------------------------------------<>--------------------------<>-------------B--------------------------<>--------------------------<>----------------------------------------XXX-
---------------------------------------XX------------------------------------------------------------------------------------------------B------------[]--------------------------------------------------------------------[]----------------------------------------<>---------------------------------------------------------------------X---------------------------------------------------------------------B-------------XXX------------------------[]--------------------------<>-------------B-------------------------------------------------------b--------------------------------------------------------------------<>---------------------------b---------------------------XX-----------[]----------------------------------------<>-------------B------------------------------------------------------[]------------[]-------------B------------<>------------[]------------[]--------------------------------------------------------------------XX-------------------------------------------------------------------------------------------------B-------------------------B--------------[]-----------------------------------------B-------------------------------------------------------------------B-------------B--------------[]----------------------------------------[]--------------------------[]-------------b--------------------------[]--------------------------[]---------------------------------------XXXX-
------------XX--------EE----------------X-----E-EE-E----------E-------------E-EE-------------EE-------------E-----------EEE--------------E------E-----[]----------EEE--------------E------------------------EE--------------[]-----------EE-----------E-E-------------[]------------E------------EE-----------EEE-E---------EEE--------------X-----------EE------------E------------E-E------------E---------------b------------XXXX----E-EE--EE------------[]---E-E------EE-E----------[]-------------b--------E-------------EE-E-E--------EE-E------------------------------------------EE--------------------------E-------------[]-----------EE----------------------------o-------------XX-----------[]----------------------------------------[]-------------b-----------------------------------------E------E-----[]----E-E-----[]-------------b------------[]---EEEE-----[]-E----------[]--------E--E------------------------EE-E----------------------E-----XX--------E--E-------------------------E--E------------------------E-EE----------------------------b----------E-E---------E--b--------------[]-E----------E-----------E----------------b---------------------------E----------EEE------EE-EE-E-E--------E--b----------E--b--------------[]--------------------------E-------------[]--------------------------[]---------------------------E------------[]----------E-E-------------[]--------------------------------------XXXXX-
XXXXXXXXXXXXXXXXXXXXXXXXXXXXX-X-XXXXXXXXXXXXXXXXXXXXXXXXXXXXXXXXXXXXXXXXXXXXXXXXX-XXXXXXXXXXXXXXXXXXXXXXXXXXXXXXXXXXXXXXXXXXXXXXXXXXXXXXXXXXXXXXXXXXXXXXXXXXXXXXXXXXXXXXXXXXXXXXXXXXXXXXXXXXXXXXXXXXXXXXXXXXXXXXXXXXXXXXXXXXXXXXXXXXXXXXXXXXXXXXXXXXXXXXXXXX-XXXXXXXXXXXXXXXXXXXXXXXXXXXXXXXXXXXXXXXXX--XXXXXXXXXXXXXXXXXXXXXXXXXXXXXXXXXXXXXXXXXXXXXXXXXXXXXXXXXXXXXXXXXXXXXXXXXXXXXXXXXXXXXXXXXXXXXXXXXXXXXXXXXXXXXXXXXXXXXXXXXXXXXXXXXXXXXXXXXXXXXXXXXXXXXXXXXXXXXXXXXXXXXXXXXXXXXXXXXXXXXXXXXXXXXXXXXXXXXXXXXXXXXXXXXXXXXXXXXXXXXXXXXXXXXXXXXXXXXXXXXXXXXXXXX-XXXXXXXXXXXXXXXXXXXXXXXXXXXXXXXXXXXXXXXXXX-XXXXXXXXXXXXXXXXXXXXXXXXXXX-XXXXXXXXXXXXXXXXXXXXXXXXXXXXXXXXXXXXXXXXXXXXXXXXXXXXXXX--XXXXXXXXXXXXXXXXXXXXXXXXXXXXXXXXXXXXXXXXXXXXXXXXXXXXXXXXXXXXXXXXXXXXXXXXXXXXXXXXXXXXXXXXXXXXXXXXXXXXXXXXXXXXXXXXXXXXXXXXXXXXXXXXXXXXXXXXXXXXXXXXXXXXXXXXXXXXXXXXXXXXXXXXXXXXXXXXXXXXXXXXXXXXXXXXXXXXXXXXXXXXXXXX-XXXXXXXXXXXX-XXXXXXXXXXXXXX-XXXXXXXXXXXXXXXXXXXXXXXXXXXXXXXXXXXXXXXXXXXXXXXXXXXXXXX---XXXXXXXXXXXXXXXXXXXXXXXXXXXXXXXXXXXXXXXXXXXXXXXXXXXXXXXXXXXXXXXXXXXXXXXXXXXXXXXX-XXXXXXXXXXXXXXXXXXXXXXXXXXXXXXXXXXXXXXXXXXXXXXXXXXXXXXXXXXXXXXXXXXXXXXXXXXXXXXXXXXXXXXXXXXXXXXXXXXXXXXXXXXXXXXXXXXXXXXXXXXXXXXXXXXXXXXXXXXXXXXXXXXXXXXXXXX-XXXXXXXXXXXXXXXXXXXXXXXXXXXXXXXXXXXXXXXXXXXXXXXXXXXXXXXXXXXXXXXXXXXXXXXXXXXXXXXXXXX--XXXXXXXXXXX-XXXXXXXXXXXXXX-XXXXXXXXXXXXXXXXXXXXXXXXXX-XXXXXXXXXXXXXXXXXXXXXXXXXXXXXXXXXXXXXXXXXXXXXXXXXXXXXX--
