-------------------------------X----------------------------------------------------------------------------------------------------------------------X---------------------------------------------------------------------------------------------------------------------------------
-------------------------------------------------------------------------------------------------------------S-----------------------------------------------------S---------------------------------------------------------S-------------------------------------------------------S--
----------------------------------------------------------------------------------------------------------------------------------------------------------------------------------------------------------------------------------------------------------------------------------------
----------------------------------------------------------------------------------------------------------------------------------------------------------------------------------------------------------------------------------------------------------------------------------------
----------------------------------------------------------------------------------------------------------------------------------------------------------------------------------------------------------------------------------------------------------------------------------------
----------------------------------------------------------S-------------------------oo------------------------E------SSSS---------------------------------------------SQ------S-----------------------------------------------E---S-------------------------ooo-----------------------X-
------------------------------------------------------------------------------------------XXXXXX----------------------------------------------------------------------------------------------------------XXXXXX--------------------------------------------------XXXXXXX---------------
---S------------------------------------------------------------------------------------------------------------------------o-----------------------------------------------------------------------------------------------------------------------------------------------------------
---S---------E----S--------E--E----------------------------------------oo---------------------------------E---------------------S------------------------------------------------------oo---------------------------------E--------------------oo---------------------------------------
------------<>----SS------<>-<>---------------X----------QQ-------Q----ooo------------XXX----------------<>------S--SSSSS-S------------------------------------------SSS------S---Q----------------X--X------------------<>---S--QQ-------------oo---------X--XXX----------------<>-----
-XX---------[]------------[X-[]--------------------------------------------------------------------------[]---EX---------------E----------------------------------E--------------------------------X---------------------[]--------------------------------X---------------------[]---E-
XXX---------[]------------XX-[]---------------------------------------------------XX---------------------[]--------------------------------<---------------------<>------------------------------XXX---------------------[]-------------------------------XX---------------------[]-----
XXX---E-E---[]---------E--XX-[]---E-----EE----XX-------------EE------------------XXX------------------E--[]-----------E-E----------------E-[---------------------[]----------EE-E----------------XXX---------------------[]----------EE-E----------------XXX---------------------[]-----
XXXXXXXXXXXXXXXXXXXXXXXXXXXXXXXXXXXXXXXXXXXXXXXXX-----XXXXXXXXXXXXXXXXXXXXXXXXXXXXXX-------------XXXXXXXXXXX----XXXXXXXXXXXXXXXXXX-X--XXXXXX--X-----------XXXXXXXXXXXXXXXXXXXXXXXXXXXXXXXXXXXXXXXXXX-------------XXXXXXXXXXXXXXXXXXXXXXXXXXXXXXXXXXXXXXXXXXX---------------XXXXXXXXX----
