---------------------------------------------------------------------------------------------------------------------------------------------------------------------------------------------------------------------------------------------------X------------------------------------
--------------------------XX---------------------------------------------------S-S-------------------------------------------------------S-----------------------------------------------------------------------------------------------XX---------------------------------------------
----------------------------------------------------------------------------SSSSSSSS-------------------------------------------------------------------------------------SSSSSSSSS-------------SX---------------------------------------------------------------------------------------
----------------------------------------------------------------------------------------------------------------------------------------------------------------------------------------------------------------------------------------------------------------------------------------
----------------------------------------------------------------------------------------------------------------------------------------------------------------------------------------------------------------------------------------------------------------------------------------
-----------------------------------------------------------------------------------------SS-----------------------------------------------S------SS---------------------------------------------------SSSSSS--------------------------------------SSS-----------SSSS--------------------
----------------------------------------------------------------------------------------------------------------------XXXXXX------------------------------------------------------------------------------------------------------------------------------------------------------------
--------------------------X-----------------------------------------------------------------------------------------------------------------------------------------------------------------------------------------------------------------XX------------------------------------------
-------------------------XXX--o-----------ooo---------------------------------E-------------------SSS?--------------------------------E-------------------oooo--------------------------------E--------------------o--------------------------------------oo---------------SS-----------
------------------------XXX----------------------------X------------------E--<>---S------SSS-------------------X--X------------------<>----------SSS-------------------X-E----------------E--<>------Q---SS---------S----------------------------E??S------S----SSSS--------------------
------E---------X------XXXX---------------------------XX---------------------[]--------------------------------X---------------------[]--------------------------------XE>--------------X<>--[]-------------------------E-------------------------------------------------------E------X
-----<>--------------XXXXXXX-------------------------XXX---------------------[]------------------------------XXX---------------------[]------------------------------XXX---------------XX[]--[]--------------------------------<-------------------------------------------------------<
-----[]-E---EE------XXXXXXX-------E-EE---------------XXX------------------E--[]-----------E-E----------------XXX------------------E--[]-----------E-E----------------XXXE-------------XXX[]--[]----------EE-E-E----------------[--XXXXX---------------------------E-E-E--------------E-[
XXXXXXXXXXXXXXXXXXXXXXXXXX--XXXXXXXXXXXXXXXXXXXXXXXXXXXX-XX----------XXXXXXXXXXXXXXXXXXXXXXXXXXXXXXXXXXX-XXXXXXX-------------XXXXXXXXXXXXXXXXXXXXXXXXXXXXXXXXXXXXXXXXXXXXX-XX-----XXXXXXXXXXXXXXXXXXXXXXXXXXXXXXXXXXXXXXX-XXXXXX----------------XXXXXXXXXXXXXXXXXXXXXXXXXXXXXXXXX-XXXXXX
