--------------------------------------------------------------------------------------------------------------------------------------------------------------------------------------------------------------X-------------------------------------------------------------------------
---------------------------------------------------------------------------------------------------------------------------------------------------------------------S-------------------------------------------------------------------------------------------------------------S-S--
------------------------------------------------------------------------------------------------------------------------------------------------------------------------------------------------------------oX---------------------------------------------------------------------SX---
-------------------------------------------------------S-----------------------------------------------------------------------------------------------------------------------------------------------------------------------S--------------------------------------------------------
-------------------------------------------------------S-----------------------------------------------------------------------------------------------------------------------------------------------------------------------S--------------------------------------------------------
----------------------------------------------SSSSS-SSSS-----SSSS---------------------------------------------S-----SSS---------SS-----------------------------------------SSSS---------SSS----------------------------S------SS----SSS---------SSS-----------------------------------E-
------------------------------------------------------------------------------------------XXXXXX--------------------------------------------------XXXXX-----------------------------------------------------------------------------------------------------------XXXXX-----------------
-------------------------------S--------------------------------------------------------------------------------------------------------------------------------------------------------------------------------------------------------------------------------------------------------
---------S-----------------E-------------------o---o------o------------oo---------------------------------E--------------------oo---------------------------------E--------------------------------------------------------oooo----------------S----------------------------------E-----
XX-----------XX-----------XX------------<>----SSSSSSSSSS--S-------------oo-------------------------------<>----------SS---------SS---------X---------------------<>---------SSS---------SSS---------------------------SSSS--SSSS-----SS---------SSS--------X---------------------<>---S-
XXX---------XXX----------EXX--XX--------[]---------------------------------------------------------------[]-------------------------------XX---------------------[]---------------E---------E---------------------------------------------E---------E------X---------------------[]-----
XXX---------XXX---------XXXX--XXXXX-----[]-----------------------------------------<---------------------[]---------------------------X--XXX---------------------[]--------------<>----------------<-------------------------------------<>----------------X---------------------[]-----
XXX---XXXXXXXXX--------EX-XX--XX-XX-----[]----E---------------E-E----------------EE[-----------------EE--[]----------EE-EE--------------XXXX-----------------EE--[]------E-------[]----------------[----XXX---------------------------E--[]---------------XX------------------E--[]-----
XXX-XXXXXXXXXXXXXXXXXXXXXXXXXXXXXXXXX---XXXXXXXXXXXXXXXXXXXXXXXXXXXXXXXXXXXXXXXXXXXX------------XXXXXXXXXXXXXXXXXXXXXXXXXXXX--XXXXXXXXXXXXXX------------XXXXXXXXXXXXXXXXXXXXXXXXXXXX-XXXXXXXXXXXXXXXXXXX---------XXXXXXXXXXXXXXXXXXXXXXXXXXXXXXXXXXXXXXXXXXX-------------XXXXXXXXXXXXXXX
