----------------------------X-----------------------------------------------------------------------------------------------------------------------------------------------------------------------------------------------------------------------------------------------------------
---------------------------------------------------------------------------------------------------------------------------------------------------------------------S--------------------------------------------------------------------------------------X---------------------------
------S------------------------------------------------------------------------------S-SSS--XX--------------------------------------------------------------------------------------------------------------------------------------------------------------SSSSSSSSSSSSSoo-----SSSSSS--
----------------------------------------------------------------------------------------------------------------------------------------------------------------------------------------------------------------------------------------------------------------------------------------
---------------------------------------ooo----------------------------------------------------------------------------------------------------------------------------------------------------------------------------------------------------------------------------------------------
---------------------------------------XX------------XSS-----SSS----------------------------------------------E-----------------------------o---------------------------------------------------------------------------------E---------------------------------------------------------
---S--------------------------o------------oo-----------------------------------------------------------------------------------------------------XXXXXX--------------------------------------------------XXXX--------------------------------------------------------------------------
------------------S---------X-------------XXX-------------------------------------------------------------------------------------------------------------------------------------------------------------------------------------------------------------------------------------------
-------------E----S---------------------------------o------------------SS?--------------------------------E--------------------oo---------------------------------E-------------------ooo---------------------------------E-------------------ooo---------------------------------------
------------<>----SS-QQQQ--------------------Q---------S-----SSS-------------------X------------------E--<>---SS-QQ------------ooo---------X--XX-----------------<>---------------------SS-----X---X------------------E--<>---------------------o----------X------------------E------QQ-
------------[]----S----------------------------------------------------------------X---------------------[]--------------------------------X---------------------[]---------------E------------X---X---------------------[]--------------------------------X-----------E----------E-----
X-----------[]----------------XXXXXX---------------------------------------------XXX---------------------[]-------------------------------XX---------------------[]--------------<>-----------X---XX---------------------[]---------------------------X---XX----------<>----X----<>-----
X-----------[]------------------------------------------------E-E----------------XXX----------------XEE--[]----------EE-E-----------------XX------------------E--[]----------EE-E[]--------------XXX-----------------EE--[]----------EE-EE---------------XXXE---------[]----X----[]--E--
XXXXXXXXXXXXXXXXXXXXXXXXXXXXXXX----------XXXXXXXXXXXXXXXXXXXXXXXXXXXXXXXXXXXXXXXXXXXXX---------XXXXXXXXXXXXXXXXXXXXXXXXXXXXXXX-XXXXXXXXXXXXX-------------XXXXXXXXXXXXXXXXXXXXXXXXXXXXX-XXXXXXXXXXXXX---XX------XXXXXXXXXXXXXXXXXXXXXXXXXXXXX---XXXXXXXXXXXXXXXXXXX----XXXXXXXXXXXXXXXXXX
