-----------------------------------------------X----------------------------------------------------------------------------------------------------------------------------------------------------------------------------------------------------------------------------------------
--------------------------X----------------------------------------------------------------------------------S-------------------------------------------------------S-----------------------------------------------------S-S-------------------------------------------------------S--
-------------------------------------------------------------------------------------------------------------------------------------------------------------------S------------------------------------------------o---SSSSSSSS--------------------------------------------------------
----------------------------------------------------------------------------------------------------------------------------------------------------------------------------------------------------------------------------------------------------------------------------------------
----------------------------------------------------------------------------------------------------------------------------------------------------------------------------------------------------------------------------------------------------------------------------------------
----------------------------XX--XX----XXX------XSSS--SSS-SS---------------------------------------------------S--------------------------------------------------------------SSS-----------------------------------------------------S----------S-------------------------------------S-
---------------------------X---------------oo---------------------------------------------X-XXXX--------------------------------------------------XXXXXX--------------------------------------------------XXXXX---------------------------------------------------XXXXXX----------------
-------------------------XXXX-----------X-XXXX------------------------------------------------------------------------------------------------------------------------------------------------------------------------------------------------------------------------------------------
-------------------------XXX-------------------------------------------oo------------------------------------------------------oo----------------------------------------oo------------ooo--------------------------------E-------------------ooo------------------------------------o--
-------------E----------XXXX-----------------Q?----------QQ-------------oo-------------------------------<>---SS--Q------------ooo---------X---------------------<>---------------------------------------------------E--<>---------------------SSS--------X--X------------------<>----S
--E---------<>--------XXXXXX-----------------------------------------------------------------------------[]--------------------------------X---------------------[]--------------------------------------------------<---[]---------------E-----------XX---X---------------------[]-----
--B---------[]-------XXXXXXX--XXXXXXXX---------------------------------------------<---------------------[]-------------------------------XX---------------------[]-------------------------------XX-----------------[]--[]--------------<>-----------X----X---------------------[]-----
--b---E-E---[]------XXXXXXXX-----X---------------------------EE-E----------------EX[---------------------[]----------EE------------------XXX---------------------[]-----------E-E----------------XXX-----------------[]--[]----------EE-E[]---------------XX---------------------[]-----
XXXXXXXXXXXXXXXXXXXXXXXXXXXXX------------X-XXXXXXXXXXXXXXXXXXXXXXXXXXXXXXXXXXXXXXXXX--------------XXXXXXXXXXXXXXXXXXXXXXXXXXXXXXXXXXXXXXXXXX------------------XXXXXXX-XXXXXXXXXXXXXXXXXXX-XXXXXXXXXX-------------XXXXXXXXXXXXXXXXXXXXXXXXXXX---XXXXXXXXXXXXX--------------XXXXXXXXXXXXXX
