-----------------------------------------------------------------------------------X----------------------------------------------------------------------------------------------------------------------------------------------------------------------------------XX----------------
-------------------------------------------------------------------------------------------------------------S-------------------------------------------------------S-----------------------------------------------------S------------------------------------------------------------
-----------------------------------------------------------------------------------------------------------S-------------------------------------------------------SX--------------------------------S-SSSSSSSS-S-------SSSSSSS---------------------------------------------------------
------------------------------------E---E-----------------------------------------------------------------------------------------------------------------------------------------------------------------------------------------------------------------------------------------------
------------------------------------XXXXXXXX--------------------------------------------------------------------------------------------------------------------------------------------------------------------------------------------------------------------------------------------
------------------------------------------------------------------------------------------------------------------------------------------------------------------------------------------------------------------------------------SSS---------SSS-----------------------------------SS
------------------------------------------------------------------------------------------XXXXXX--------------------------------------------------XXXXX---------------------------------------------------------------------------------------------------------------------------------
----------------------------------------------------------------------------------------------------------------------------------------------------------------------------------------------------------------------------------------------------------------------------------------
-------------E----------E---------------------------------------------------------------------------------E--------------------oo---------------------------------E-------------------ooo---------------------------------E-------------------------------------------------------------
------------<>---------<>--------??-----------------------Q------QQQQQQQ------X--------------------------<>---------------------o----------X------------------E--<>--------------------------------X------------------E--<>---S------SS---------SSS--------X-------------------------SSS
------------[]---------[]-----------------------------E--------------------------------------------------[]---------------E------------E---X-----------------<---[]--------------------------------X------X---------X<---[]---------------E---------E------X----------------------------
------------[]---------[]-----------------------------b----------------------------X---------------------[]--------------<>----------------X-----------------[]--[]------------------------------XXX----------------X[---[]--------------<>-----------X----X----------------------B-----
-XX---E-----[]-----E---[]--------------E-E-E----------B------E--------------------XX---------------------[]----------EE--[]---------------XX-----------------[]--[]----------EE-EE---------------XXX---------------XX[E--[]--------------[]---------------XX----------------------b-----
XXXXXXXXXXXXXXXXXXXX---XXXXXXXXXX--XXXXXXXXXXXXXXXXXX-XXXXXXXXXXXXXXXXXXXXXX----XXXX-------------XXXXXXXXXXXXXXXXXXXXXXXXXXXX--XXXXXXXXXXXXX------------XXXXXXXXXXXXXXXXXXXXXXXXXXXXX--XXXXXXXXXXXXXXXXXX-----XXXXXXXXXXXXXXXXXXXXXXXXXXXXXX-XXXXXXXXXXXXXXXX-------------XXXXXXXXXXXXXX
