-----------------------------------------------------------------------------------X----------------------------------------------------------------------------------------------------------------------------------------------------------------------------------------------------
---------------------------------------------------------------------------------S------------------------------------------------------------------------------------------------------------------------------------------------------------------------------------------------------
------S-------------S-SSSSSS-------------------------------------------------------------------------------------S?-S----------------------------------------------------S--S------------------SX-------------------------------SSSSSSSSSSSSS----------SS-------------------------------
------------------S----SS---------------------------------------------------------------------------------------------------------------------------------------------------------------------------------------------------------------------------------------------------------------
------------------SSS-SSSSSS------------------------------------------------------------------------------------------------------------------------------------------------------------------------------------------------------------------------------------------------------------
-------------SSSS---SSSSSSSS-----------------SSS--------ooo---E--------------------------SSS----------------------------------------------Q---S--SSS----------------------------------------------------------------SS---------X--------------------------------------------------------
---X----------------------------------------------------------XXXXXX--------------------------------------------------X----------------------------------------------------------X--------------------------------------------XX--------------------------------------------------------
----------------------------------------------------------------------------------------------------------------------------------------------------------------------------------------------------------------------------E-XX--------------------------------------------------------
-------------------------------X---------E--SSSS---------------------------------------------------oo---------------------------------E--------------------oo---------------------------------E--------------------------------X----------------------E------------------SSSS?----------
---Q----S----E----SSSSSSSSS---XX--------<>-------------E--XXX----------------<>------SS--SSS---------o---------X---------------------<>---S--SS--SS---Q------o---------X------------------E--<>---S-----------E-----SSS----XX--X-E----------------E--<>--------------------------------X
---X--------<>---------S-SS--XXX--------[]------------<>---------------------[]--XXX---------------------------X---------------------[]--------------------------------X-----------------<---[]--------------<>----------XXXX--X------X--------XX<>--[]-------------------------------XX
---X--------[]---------SSSS--XXX--------[]------------[]---------------------[]-------------------------------><---------------------[]-------------------------------XX-----------------[]--[]--------------[]---------X-XXX--X--------------XXX[]--[]------------------------------XXX
------------[]----EEEoESSSS--XXX----EE--[]------------[]---------------------[]----------EE-E----------------E][----------------EEE--[]----------EE-E----------------XX[-----------------[]--[]--------------[]--------EX-X-X-XX-------------XXXX[]--[]-----------------E-----------XXXX
-XXXXXXXX----XXXXXXXXXXXXXXXXXXXXXXXXXXXXXXXXXXXXXXXXXXX-------------XXXXXXXXXXX----XXXXXXXXXXXXXXXXXXXX-XXXXXXXXXXX-------XXXXXXXXXXXXXXXXXXXXXXXXXXXXXXXXXX-XX-XXXXXXX---XX------XXXXXXXXXXXXXXXXXXXXXXXXXXXXXXXXXXXXXXXXXXXXXXXXXX-X--XXXXXXXXXXXXXXXXXXXX-XXXXXXXXXXXXXXXXXXXXXXXXXX
