-----------------------------------------------------------------------------------X--------------------------------------X-------------------------------------------------------------------------------------------------------------------------------------------------------------
---------------------------------------------------------------------------------------------------------------------------------------S-S-------------------------------------------------------S-------------------------------------------------------S------------------------------
S----SSSSSSSSoo-------X-X-S--------------------------------------------------------------------------------------------------------------------------------------------------------------------S----------------------------------------------------------------------------------------
X---------------------------------------------------------------------------------------------------------------------------------------------------------------------------------------------------------------------------------------------------------------------------------------
----------------------------------------------------------------------------------------------------------------------------------------------------------------------------------------------------------------------------------------------------------------------------------------
-----o-ooo-----------SS-------------------SS------------ooooo-o-------------------?------S------------------------------------------------S---SS-SS------------------------------------------------------S----------------------o-------------------------E------SS---------------------
---------------------------------------------------------------XXXX------------------------------------------------------XX---------------------------------------------------XXXXXX--------------------------------------------------XXXXXX--------------------------------------------
----SSSSSS--------S--------------------o------------------------------------------------------------------------------------------------------------------------------------------------------------------------------------------------------------------------------------------------
-----S--SSS-------S----------------------S--S--------------XXX------------------------------------ooo------------------------------------------------------oo---------------------------------E--------------------oo---------------------------------E--------------------oo-----------
S--------S---S----SSSSQQ---------------SS-----------------------------------------------------------SS---------X----------------------E--SSS-QQ-------------oo---------X---------------------<>---------------E-----SSS--------X--XX-----------------<>------SS--SS--------------------X
S-----------------X----------XXX--------------------------------------------XXXXXXXX----------E------------E---X---------------------<>--------------------------------X---------------------[]--------------<>------------E---X---------------------[]--------------------------------X
X----------------------------------B---------------------------------------------------------<>-----------X----X---------------------[]-------------------------------XX---------------------[]--------------[]-----------X----X---------------------[]-------------------------------XX
-----------------------------------b----------------EEE----------------------------------EE-E[]---------------XX---------------------[]----------EE-E----------------XXX------------------E--[]----------EE--[]---------------XX-----------------EE--[]----------EE-E----------------XXX
--XXXXXXXXXXXXX-XXXXXXXXXXXXX---XXXXXXXXXXX--XXXXXXXXXXX----------------------------XXXXXXXXXXXXXXXXXXXXXXXXXXXX---------------XXXXXXXXXXXXXXXXXXXXXXXXXXXXXXXXXXXXXXXXX-------------XXXXXXXXXXXXXXXXXXXXXXXXXXX---XXXXXXXXXXXXX------------XXXXXXXXXXXXXXXXXXXXXXXXXXXXXXXXXXXXXXXXXXXX
