----------------------------------------------------------------------------------------------------------------------------------------------------------------------------------------------------------------------------------------------------------------------------------------
-------------------------------------------------------------------------------------------------------------------------------------------------------------------------------------------------S--------------------------------------------------------------------------------------
-----------------------------------------------------------------------------------------------------------------------------------------------------------------------------------------------S----------------------------------------------------------------------------------------
----------------------------------------------------------------------------------------------------------------------------------------------------------------------------------------------------------------------------------------------------------------------------------------
----------------------------------------------------------------------------------------------------------------------------------------------------------------------------------------------------------------------------------------------------------------------------------------
-------------------------------------SSSSSSS----------------------------------------------------------------------------------------------E---S-SSSS------------------------------------------------------------------------------------------------------S-----SSS---------------------
-----------------------------------------------------------------XX---------------------------------------------------XXXXX---------------------------------------------------XXXXX---------------------------------------------------XXXXXX--------------------------------------------
---------------------------X------------------------------------------------------------------------------------------------------------------------------------------------------------------------------------------------------------------------------------------------------------
-------------E-------------X-------------S--------------------------------------------------------ooo---------------------------------E--------------------oo---------------------------------E-------------------ooo---------------------------------E--------------------oo-----------
--E----------E-------------X-------S---SS------------------------------------<>--------------------------------X------------------E--<>------QS--SS---------So---------X------------------E--<>---------------------SS-----X---X---------------------<>---S------SS---------S----------X
-->---------<>--------------------------------------E------------------------<>-------------------------------XX---------------------[]--------------------------------X---------------------[]---------------E-----------XX--XX---------------------[]---------------E----------------X
-[]---------[]--------------------------E----------<>------------------------[]------------------------------XXX---------------------[]--------------------------------<---------------------[]---------------------------X-XXXX---------------------[]--------------------------------X
-[]---E-E---[]-----E-----------EE-E----------------[]------------------------[]----------EE-E----------------XXX-----------------EE--[]----------EE-E----------------EX[------------------E--[]----------EE-EE--------------XXXX------------------E--[]----------EE-EEE---------------XX
XXXXXXXXXXXXXXXXXXXX------XXXXXXXXXXXXXXXXXXXXXXXXXXXXXX----------------XXXXXXXXXXXXXXXXXXXXXXXXXXXXXXXXXXXXXXXX----X-------XXXXXXXXXXXXXXXXXXXXXXXXXXXXXXXXXXXXXXXXXXXX-------------XXXXXXXXXXXXXXXXXXXXXXXXXXXX--XXXXXXXXXXXXX-------------XXXXXXXXXXXXXXXXXXXXXXXXXXXXXXXXXXXXXXXXXXX
