----------------------------------------------------------------------------------------------------------------------------------------------------------------------------------------------------------------------------------------------------------------------------------------
-------------------------------------X---------------------------------------------------------------------------------------------------------------------------------------------------------------------------------------S-------------------------------------------------------S--
----------------------------------------------------------------------------------------------------------------------------------------------------------------------------------------------------------------------------------------------------------------------------------------
-------------------------------------------------------S--------------------------------------------------------------------------------------------------------------------------------------------------------------------------------------------------------------------------------
----------------------------------------------------------------------------------------------------------------------------------------------------------------------------------------------------------------------------------------------------------------------------------------
-----------------------------------------------S--------------------------------------------------------------SS-----SS----------S------------oo----------------------SS----SSS---------SSS-----------o-----------------------S---S--SS---------------------o---------------------------
---S-------------------------------------------S---------------------------------------------XXX---o-------------------------------------------------XXX---o-------------------------------------------------XXX---o----------------------------------------------XXXXXX----------------
--------------------------------------------------------------------------------------------------X------------------------------------------------------XXXX----------------------------------------------------XXXX-------------------------------------------------------------------
---S---------E----------E----------------------o-ooooooo--------------SSS------------------------------------oo---------------SSS?----------------------------------oo------------------------------------------------------oo-----------------oo---------------------------------E-----
---Q--------<>----S----<>--------------------E??SS----SS---------------------------X----------------------E---SS-----SSS-------------------X----------------------E----S-----SS---------SSS--------X------------------------------Q-------------oo---------X--XXX----------------<>-----
-X----------[]---------[]----------------------------------------------------------X---------------------<>-------------------------------XX---------------------<>---------------E---------E-X----X---------------------<>--------------------------------X---------------------[]-----
XX----------[]---------[]-----------------X--------------------------------------XXX------X--------------[]------------------------------XXX---------------------[]--------------<>-----------X----X---------------------[]--------------------------------X---------------------[]-----
-X-------E--[]---------[]------XXXXX------------------------E-E-EE--E------------XXX---------------------[]-----------E-EE--------------XXXX---------------------[]--------------[]---------------XX---------------------[]----------EE-EE---------------XXX------------------E--[]-----
XXXXXXXXXXXXXXXXXXXX-XXXXXXXXXXXXX-------X--XXXXXXXXXXXXXXXXXXXXXXXXXXXXXXXXXXXXXXXXXX------------XXXXXXXXXXXXXXXXXXXXXXXXXXXXXXXXXXXXXXXXXX---------------XXXXXXXXXXXXXXXXXXXXXXXXX--XXXXXXXXXXXXXX---------------XXXXXXXXXXXXXXXXXXXXXXXXXXXXXXXXXXXXXXXXX------------XXXXXXXXXXXXXXXX
