------------------------------X-------XX------------------------------------------------------------------------------------------------------------------------------------------------------------------------------------------------------------------------------------------------
-----------------------------------------------------------------------------------------------------------S-S-------------------------------------------------------S-------------------------------------------------------S-------------------------------------------------------S--
-------------------------------------------------------------------------------------S-SS---X---S--------XoSSS-S--------------------------------------------o---------------------------------------------------------------------------------------------------------------------------
----------------------------------------------------------------------------------------------------------------------------------------------------------------------------------------------------------------------------------------------------------------------------------------
----------------------------------------------------------------------------------------------------------------------------------------------------------------------------------------------------------------------------------------------------------------------------------------
----------------------------------------------SSSS---SSS-----SS----------------------------------------------------SSSS---------------------------------------------------S--SS---------------------oo------------------------E--SSSSSS-----------------------------------------------E-
-------------------------------------------o------------------------------------------------------------------------------------------------------XXXXX---------------------------------------------------XXXXXX--------------------------------------------------XXXXXX----------------
---------------------------X------------------------------------------------------------------------------------------------------------------------------------------------------------------------------------------------------------------------------------------------------------
-------------E-------------X------------------------------------------oooo-----------------------------------------------------oo------------------------------------------------------oo---------------------------------E--------------------oo---------------------------------E-----
------------<>----SS-------------------------QSS-----SSS-----SS--------------------X------------------E--<>---S-----------------SS---------X---------------------<>------QS-------------oo---------X--XXX----------------<>------QQ-------------oo---------X--XX-----------------<>-----
------------[]---------------------------------------------------------------------X------X---------X<---[]---------------E----------------X---------------------[]--------------------------------X---------------------[]---------------E----------------X---------------------[]-----
------------[]----------------XXXXXX---------------------------------------------XXX----------------X[]--[]--------------<>----------------X---------------------[]--------------------------------X---------------------[]--------------------------------<---------------------[]-----
------E-E---[]-----------------X-X----------------------------E-EE---------------XXX----------------X[]--[]----------EE-E[]---------------XX------------------E--[]----------EE-EE---------------EX[---------------------[]----------EE-EE----------------E[-----------------EE--[]-----
XXXXXXXXXXXXXXXXXXXX---XXXXXXXXX---------XXXXXXXXXXXXXXXXXXXXXXXXXXXXXXXXXXXXXXXXXXXXX----------XXXXXXXXXXXXXXXXXXXXXXXXXXXXXXXXXXXXXXXXXXXX-------------XXXXXXXXXXXXXXXXXXXXXXXXXXXXXXXXXXXXXXXXXXX-------------XXXXXXXXXXXX-XXXXXXXXXXXXXXXXXXXXXXXXXXXXXX------------XXXXXXXXXXXXXXXX
