----------------------------------------------------------------------------------------------------------------------------------------------------------------------------------------------------------------------------------------------------------------------------------------
X----------------------------------------------------S---------------------------------------------------------------------------------------------------------------S------------------------------------------------------------------------------------------------------------------
-------------------------------------------------------------------------------------S?--------------------------------------------------------------------------XXSSS------------------------------------------------------------------------------------------------------------------
----------------------------------------------------------------------------------------------------------------------------------------------------------------------------------------------------------------------------------------------------------------------------------------
------------------E---------------------------------------------------------------------------------------------------------------------------------------------------------------------------------------------------------------------------------------------------------------------
-----SSS--------SSSSS---------------------------------S------SSS------------------------------------------------------SS-----------------------------------------------------SS-----------------------------------------------E-----------------------------oo------------------------E-
-------------------------------------XXX---o----------------------------------------------XXX--------------------------------------------------------X-----------------------------------------------------X-X----------------------------------------------------XXXXXXX---------------
-----------------------------------------XXXX-------------------------------------------------------------------------------------------------------------------------------------------------------------------------------------------------------------------------------------------
---------------S------------------------------------oo-----------------oo---------------------------------E-------o------------oo---------------------------------E-------------------oooo--------------------------------E-------------------ooo---------------------------------E--o--
---QSSSS-----------------------------------------------S------S---------oo---------X<E----------------E--<>------SS-------------oo----------------------------E--<>---S----------------------------X------------------E--<>---------------------SS---------X--XXX----------------<>-----
--------------------E------X-------------------------------------------------------X[]--------------X<>--[]--------------------------------X-----------------<---[]--------------------------------X---------------------[]---------------E------------E---X---------------------[]-----
---------------------------X------X--------------E>--------------------------------<[--------------XX[]--[]-------------------------------XX------------------]--[]------------------------------XXX---------------------[]--------------<>-----------X----X---------------------[]-----
-E-------EE----------------X---------------------[]----------EE-EE---------------EX[[--------------XX[]--[]----------EE-E----------------XXX-----------------[E--[]-----------E-EE---------------XXX-----------------EE--[]----------EE-E[]---------------XX------------------E--[]-----
XXXXXXXXXXXX-XXXXXXXX-XXXXXX---------------XXXXXXXXXXXXXXXXXXXXXXXXXXXXXXXXXXXXXXXXX----X-----XXXXXXXXXXXXXX-XXXXXXXXXXXXXXXXXXXXXXXXXXXXXXX---XX------XXXXXXXXXXXXXXXXXXXXXXXXXXXXXXXXXXXXXXXXXXXXX---XX------XXXXXXXXXXXXXXXXXXXXXXXXXXXXX---XXXXXXXXXXXXX------------XXXXXXXXXXXXXXXX
