----------------------------------------------------------------------------------------------------------------------------------------------------------------------------------------------------------------------------------------------------------------------X-----------------
----------X----------------------------XX---XXX-------X----------------------------------------------------S-SS------------------------------------------------------S-------------------------------------------------------S----------------------------------------------------------
----------------------------------------------------------------------------------------------X-S?o---SSSSSSSSSS-----------------------------------------------------------------------------------------------------------SX-----------------------------------------------------------
----------------------------------------------------------------------------------------------------------------------------------------------------------------------------------------------------------------------------------------------------------------------------------------
----------------------------------------------------------------------------------------------------------------------------------------------------------------------------------------------------------------------------------------------------------------------------------------
----------------SS---------S-------------------XXXX------------------------------------------------------------------SSS--------------------o-------------------------E--------------------------------------------------------------SSS---------------------------------------------SSS
----------------------------------------------------------------------o---------------------------------------------------------------------------XXXXXX--------------------------------------------------XXXX------------------------------------------------------XXXX----------------
----------------------------------------------------------------------------------------------------------------------------------------------------------------------------------------------------------------------------------------------------------------------------------------
-------------E--------------------------------------oo-------------E----------------------------------------------o------------oo---------------------------------E--------------------oo---------------------------------E--------------------oo---------------------------------------
---X--------<>---------------------------SSS------E--S-S----------<>-------X--------------------------E--<>-------S-------------oo------------XX-----------------<>-------Q-------Q-----------------------------------E--<>------SS--SS---Q----------------X---------------------<>--SSS
-XXX--------[]----------E------------------------<>---------------[]----------X--------------------------[]--------------------------------X---------------------[]--------------------------------X---------------------[]--------------------------------X---------------------[]-----
-XXX--------[]---------<>------------------------[]---------------[]---------XXXX------------------------[]-------------------------------XX---------------------[]-------------------------------XX-----------------[]--[]-------------------------------XX---------------------[]-----
-XXX----EE--[]-----E---[]---XSSSS----------------[]---------E--E--[]---------XX--------------------------[]-----------E-E----------------EXX------------------E--[]----------EE-E----------------XXX-----------------[]--[]----------EE-E----------------XXX---------------------[]-----
XXXXXXXXXXXXXXXXX--XXXXXXXX-XXXX-XXXXX--XXXX-----XX-----XXXXXXXXXXXXXXXXXXXXX---X------------------XXXXXXXXXXXXXXXXXXXXXXXXXXXXXXXXXXXXXXXXX-------------XXXXXXXXXXXXXXXXXXXXXXXXXXXXXXXXXXXXXXXXXXX---XX------XXXXXXXXXXXXXXXXXXXXXXXXXXXXXXXXXXXXXXXXXXXXX-------------XXXXXXXXXXXXXXX
