-------------------------------X----------------------------------------------------------------------------------------------------------------X---------------------------------------------------------------------------------------------------------------------------------------
-----------------------------------------------------------------------------------------------------------------------------------------------------------------------------------------------------------------------------S----------------------------------------------------------
--------------------S?-----------------------------------------------------------------------------------------------------------------------S------------------------------------------------------------------------------------------------------------------------------------------
----------------------S-----------------------------------------------------------------------------------------------------------------------------------------------------------------------------------------------------------------------------------------------------------------
------------------S-----S--S------------------------------------------------------------------------------------------------------------------------------------------------------------------------------------------------------------------------------------------------------------
--------------SSSSSSSSSSSSSS----------------------------------------------------------------------------------E-------------------------------------------------------SQ------SQ----------------------------------------------E-------------------------------------------------------E-
-----------------------------------------------------------------------------------------------------------------------------------------------------X----------------------------------------------------XXXXXX--------------------------------------------------XXXX------------------
----------------------------------------------------------------------------------------------------------------------------------------------------------------------------------------------------------------------------------------------------------------------------------------
-------------------?---------------------------------------------------oo---------------------------------E-------------------ooo---------------------------------E--------------------oo---------------------------------E--------------------oo---------------------------------E-----
--X---------XXX---SS?SSS-----------------------------S----------QQQQ----------------------------------E--<>--------------------------------X---------------------<>--SSS-SS---S-Q-Q----------------X--XX-----------------<>-------Q-------------------------------------------E--<>---S-
-----------XXXX----------------------------E---------------------------------------X---------------------[]-------------------------------XX---------------------[]--------------------------------X---------------------[]--------------------------------X---------------------[]-----
----------XXXXXX--------------------------<>------B-------------------------------XX-----------------[]--[]------------------------------XXX---------------------[]-------------------------------XX---------------------[]-------------------------------XX---------------------[]-----
-----X---XXXXXXX---E---------EEEEE-E------[]------bE-E-------E--E----------------XXX---E-----------E-[]--[]-----------E------------------XXX------------------E--[]----------EE-E----------------XXX------------------E--[]----------oo------------------XXX-----------------EE--[]-----
-XXXXXXXXXXXXXXX---XXXXXXXXXXXXXXXXXXX-XXXXXXXXXXXXXXXXXXXXXXXXXXXXXXXXXXXXXXX--XXXXXX-XXX----XXXXXXXXXXXXXXXXXXXXXXXXXXXXXXXXXXXXXXXXXXXXXX--XXX------XXXXXXXXXXXXXXXXXXXXXXXXXXXXXXXXXXXXXXXXXXXXX-------------XXXXXXXXXXXXXXXXXXXXXXXXXXXXXXXXXXXXXXXXXXX---XX------XXXXXXXXXXXXXXXXX
