--------------------------------------X-------------------------------------------------------XX----------------------------------------------------------------------------------------------------------------------------------------------------------------------------------------
---------------------------------------------------------------------------------------------------------------------------------------------------------------------S---------------------------------------------------------------------------------------------------------------S--
-------------------------------------------------------------------------------------------------------------------------------------------------------------------S--------------------------------oSSSSSS-----------------------------------------------------------------------------
----------------------------------------------------------------------------------------------------------------------------------------------------------------------------------------------------------------------------------------------------------------------------------------
----------------------------------------------------------------------------------------------------------------------------------------------------------------------------------------------------------------------------------------------------------------------------------------
-----------------------------------------------------SSS-----SS----------------------------------------------SSS-----SSS--------------------------------------------------SSSSS-----------------------------------------------E------SS-----------------------------------------------E-
-----------------------XX---X---------XX----------------------------------------------------------------------------------------------------------XXXX------------------------------------------------------------------------------------------------------------XXXX------------------
-----------------------XX---------------------------------------------------------------------------------------------------------------------------------------------------------------------------------------------------------------------------------------------------------------
--E--------------------XX----------------------------------------------oo------------------------------------------------------SSo--------------------------------E--------------------oo---------------------------------E--------------------oo---------------------------------E-----
-<>--------------------XX----------------------------SSS-----SS--------------------X-------------------------SSS-----SSS--------------------------------------E--<>------QQ-------------oo---------X-E----------------E--<>--SS---Q-------------o----------X------------------E--<>-----
-[]-------------X---X--XX-------------------------E--------------------------------X-------------------------------------------------------------------------<---[]---------------E----------------X---------------------[]--------------------------------X-----------------<---[]-----
-[]---------------XXX--XX------------------------<>------------------------------XXX----------------------B------------------------------<><-----------------[]--[]--------------<-----------------X---------------------[]-------------------------------XX-----------------[]--[]-----
-[]--------EEE----XXX--XX------------------E-----[]--E-------EE-E----------------XXX----------------------b-----------E-E----------------[][-----------------[]--[]----------EE-EE----------------XX-----------------EE--[]----------EE-E----------------XXX-----------------[]--[]-----
XXXXXXXXXXXXXXXXXXXXXXXXXXX-XXXXXXXX-----XXXXXXXXXXXXXXXXXXXXXXXXXXXXXXXXXXXXXXXXXXXXXX-----------XXXXXXXXXXXXXXXXXXXXXXXXXXXXXXXXXX-XXXXXXX------------XXXXXXXXXXXX--XXXXXXXXXXXXXXXXXXXXXXXXXXXXXXXXXXX-----XXXXXXXXXXXXXXXXXXXXXXXXXXXXXXXXXXXXXXXXXXXXXX---XX------XXXXXXXXXXXXXXXXX
