--------------------------------------XX-------X----------------------------------------------X-----------------------------------------------------------------------------------------------------------------------------------------------------------------------------------------
S-------------------------------------X-----X--------------------------------------------------------------S-S---------------------------------------------------------------------------------------------------------------S-------------------------------------------------------S--
--------------------------------------------------------------------------------------------------------------------------------------------oS-SSSSSSSS-S-------SS-SSS------------------------------------------------------------------------------------------------------------------
----------------------------------------------------------------------------------------------------------------------------------------------------------------------------------------------------------------------------------------------------------------------------------------
------------------------------------------------E-------------------------E-------------------------------------------------------------------------------------------------------------------------------------------------------------------------------------------------------------
----------------------------------------------SSSSSS-SSS----SSS----------S--------------------------------------------------------------------------------------------QQ--------------------------------------------------------------------------------------------------------------E-
----------------------------------------------------------------------------------------------------------------------------------------------------------------------------------------------------------XXXXXX--------------------------------------------------XXXXXX----------------
----------------------------------------X--------------------------------------------------------X--------------------------------------------------------------------------------------------------------------------------------------------------------------------------------------
------------------------------------------------------------------------------------------------------------------------------ooo------------------------------------------------------oo---------------------------------E-------------------oooo--------------------------------E-----
E--------------------------------------------QS?S----S------SSS--------------------X--------------------------SS---------------------------X-------------------------?SS----------------SSS---XXX--X---X-----------------<>--------------------------------X---------------------<>-----
----------------<E----------------------------------------------------------E------X------------------------------------------------------XX----------------------E---------------E----------XXXX--X---------------------[]--------------------------------X---------------------[]-----
----------------[>-----------------------X-----------------------------------------X----------------------B-----------------------------XXXX---------------------<>--------------<>----------XXXX--X---------------------[]------------------------------XXX---------------------[]-----
E--E-------E----[]------------XXXX------------------------------E-E--------------XXX----------------------b----------EE-E---------------XXXX---------------------[]--E-------E---[]--------EX-X-X-XX------------------E--[]-----------EEEE---------------XXX-----------------EE--[]-----
XXXXXXXXXXXXXXXXXXXXXXXXXXXX-----X----------XXXXXXXXXXXXXXXXXXXXXXXX-XXXXXXXXXXXXXXX---------------XXXXXXXXXXXXXXXXXXXXXXXXXXXXXXXXXXXXXXXXXXXXXXXX---XXXXXXXXXXXXXXXXXXXXXXXXXXXXXX---XXXXXXXXXXXXX-------------XXXXXXXXXXXXXXXXXXXXXXXXXXXXXXXXXXXXXXXXXXX------------XXXXXXXXXXXXXXXX
