-----------------------------------------------------------------------------------------------------------------------------------------------------------------------------------------------------------------------------------------------------------------------------------------------------------------------------------------------------------------------------------------------------------------------------------------------------------------------------------------------------------------------------------------------------------------------------------------------------------------------------------------------------------------------------------------------------------------------------------------------------------------------------------------------------------------------------------------------------------------------------------------------------------------------------------------------------------------------------------------------------------------------------------------------------------------------------------------------------------------X-----------------------------------------X--------------------------------------------------------------------------------------------------------------------------------------------------------------------------------------------------------------------------------------------------------------------------------------------
--------------------------------------------------------------------------------------------------------------------------------------------------------------------------------------------------------------------------------------------------------------------------------------------------------------------------------------------------------------------------------------------------------------------------------------------------------------------------------------------------------------------------------------------------------------------------------------------------------------------------------------------------------------------------------------------------------------------------------------------------------------------------------------------------------------------------------------------------------------------------------------------------------------------------------------------------------------------------------------------------------------------------------------------------------------------------------------------------------------------------------------------------------------------------------------------------------------------------------------------------------------------------------------------------------------------------------------------------------------------------------------------------------------------------------------------------------
------------------E---------SSSSSS------------SS----------------------SSSSSSSSSS---------------------------------------------------------ooo-------------------------------SS-----------------------------------------S-----------------------------------oo----------------------------SSSSSSSSSSSSSS----------------------------SSSSSSSSSSSSSS-----------oo-------------------------------------------SSSSSSSSSSS---------------------------------------------SSSSSSSSSSSSSS----------------------------SSSSSS--SSS------SS-----------------S---------S---------S---------------------------------------------------------SSS---------S--SSS------------S--------o----------------SSS--------------------------SS---------------------------SS--------------------------SSSSSSSSSS---SS-----------------------SSSSSSSSS-S-------------------------------SSSSSSSSSSSSSS--------------------------------S-----------------------------------oo-----------------------------------------------------------------------------------------------------SS---------------SSSSSSSS---SSS------------SS--------------oo----------------------------------------S?--oooo----------------------------SSSSSSSSSSSSSS----S-----------SSS------------------------------------------------------SS----------------o-------S--SS------ooSS-SS---SS---SSSSSSSSSSSS--S-----------------SSS---------------------o----------------------------------------oo--------------
----------E------------------SSSSS-----------SS------------------------SSSSSSSSSS-------------------------------------------------------------------------------------------------------------------------------------S------------------------------------------------------------------------------------------------------------------------------------------------------------------------------------------------------------------------------------------------------------------------------------SSSSS--------------------------S-------------SS------------------------------------------------------------------SSS------------SSS------------SS------------------------SSS---------------------------S---------------------------------------------------------------------S---------------------o--SSSSSSS-------------------------------------------------------------------------------SS----------------------------------------------------------------------------oo-------------------------------------------------------------S-------------------------SSSS------------SS----------------------------------------------------------------------------o--------------------S------------S-----------S-S------------------------------------------------------SS----------------o----------SS------------S---------SSSSSSSSSS---------------------SSS------------------------------------------------------------------------------
------E--X-XXX---S-----oo---oSSSSS---o-----S-SS----o------------------SSSSSSSSSSS-----------------------------------------------------------oo-o-----oo----------------------------------o---------------------------SS----o----ooooo--oooo-----------------o--o----------------------------------------ooo------------------------------------------------------SS----oo-----------------o--o--------------------------------------------------------------------------------o--------oo---ooooo---oo----oSSSSS-----------SS-------------S----------E-S-S----------------------o------------------------------------------SSSS------------SSS------------SS-----------------------SSSS--------------------------SS--------------------------SS----oo--------------------------------S-SS-----------------------oSSSSSSS--------ooo----o---------------------------------------------------------------SS----o------oo-----oo-----------------------------------------------------------------------------------------------------oooo-------------SS-----------------------oSSSSS---oo------SSS---------------------------------------o-----oo--------------------------------------------------SS--------?-SS----oo----SSSS-----------------------ooooo--oooo------------------S-SS---------------------------SS------------S---------SSSSSSSSSS-------------------S-SSS---oo-----------------ooooo---ooo---------------------------------------------
-------------?----------X------------XX------------XX-----------------SSSSSSSSSSS-------SSSS------------------------------?SSS---------------------------------------------------------------------------------------------XX--------------------------------------------------------------------------SSSS--------------------SSS-------------------------------------XX--------------------------------E-------ooooo-----------SSS-----------------------SQS-----------------------------------------------------S-----------------------------Q--SSSSSSSSSSSS--S----------Q---------------------------------------SQS-----------S-------SSS---?--------------------------------S--SS---SS--------------X-----------------------------------------X----------------------------------------SX------------S?SSS--SSSS--S?-----------------------------------------------------------------------------------XX------------X-------------XX--------------QQS---------------XXS-------SSS------------------------QQQ--------------S--------o------------------------------------S-----XX------SS----?-----------------Q-----------------------XX-----------------XXX--------SSSS--?-------SSS-----------------------XX------------SQ-------------------------------------------------------X--------------------------?----------S--S-------SSSS-SS---------------------SS----XX--------------SSS---------------------------------------SSS--------------
----------------------------------------------------------------------------------------------------------------------------------------------------------------------------------------------------------------------------------------------------------------------------------------------------------------------------------------------------------------------------------------------------------XXXX-X------------------------------------o--------------XX---------------------------------------------------------------------------------------------SS------------------------------------------------------------------------------------------------------------------------------------------------------------------------------------------------------------------------------XXX-------------------------------------------------------------------------------------------------------------------------------------------X-------------------------XXX-----------------------------------------------------------------------------------------------------------------------------------------------------------------------------------XXX-----------------------------------------------------------------------------------------------------------------------------oooo----------------------------------------------------------------------------------------------------------------------------------------------------
-------X--------------------------------------------------------------S-------S---------------------------S---------------------------------------------------------------------S---------------------------------------------------------------------------------------------------------------------------------------------------------------------------------------------------------------------------------------------------------------------------------------------------------------------------------------------------------------------------------------------------------------------o---------------------------S-------------------------------------------------------S---------------------------------------------------------------------------------------------------------------------------------------------------------o-----------------------------------------------------------------------------------------------------------------------------------------------------------------------------------------------------------------------------------------------------------------------------------------------------------------------------------------------------------------------------------------------------------------------------------------XXXXXXX-------------------------------------------S-------------------------------------------------------------------------------------------------------
------------------SSS---S-SS---ooooo---------ooooo-----------SSS--oo----ooooooo-------E------------------SSSS----------------------E----------------------------ooo------------SSSS-------SSSS------------------------SSSS------------------------oooo-----------------------------------------------------------------------------S-----------------E------------SSSS-----------SSSS---------------------------------------ooo----------SSS-----------------------------------------------------------------o-ooo----------SSSSS-S-------------------Eo----------SS----------------------------------S?--------------------------SS------oooo-----------o--ooo---------------------------SSS-------oooo----------SSSSS---------------ooo-----SSSS----------SSSS------------oo-----------SSS----------------------oooooo------------S---------------S?--------------------------------------------------oooo----------SSS-----------oo----------------o--------------------------------------------------------------------oo-----------------------SSSSS-S---------oo---------ooooo--------ooooo---------------------------------------SSS-----------------------------o----------------E-----?---o----------SSSS--------------S-----------S-------------------------SSSSS-S-------SSSSS------------------E---ooooo-------S--------------ooooooo-----------S---------ooooo----------------------------------------SSS----------------------------------
----X---X------------------------?-------------------------------------SSSSSS-SSS------SSSSSS----X---S---------------------------SSSS----X--------------------------------------------------------------SS----<>-----------------------------------?--------------------------------<>-----------------------------------------------------QQQ----?SSSS----X--------------------------------------------XXXX--------XX-----------------------------------------------------XXX----------------------------------?SSQ---------------------------QQQ-QSSSSSSS------------------QQ-----------------SS--------------------------S------SS----SSSSSS------------o?S----------------<>----SSS----S-------------------------------------------------------------------------------o?S---X-----------------------------S-??SSSSS----------------------SS-----------??S-SSSS---------------<>-------------------------------------------------------E-----------Q--SQ-----------------XX--------S-----------------------QQQQQ-------------------------E---------------------o-----XX------------------SSSS-----------------XXX---S?SQS----E---------------------o-----E---------------S-------------------E?SSQ---------------------------SQ-----------------------------------------------------------------------<>-----??S--------------SQQQQQ--SSSSSSSSS--------------------SSS-------------------------------------------------------------E----------------
----X---X----------------------------------------------------------------------------------------X-------------E------------------------XX--------------------------------------------------------------------[]-----------------------------------------B--------------------------[]-----------------------------------------E--------------------------XX-----------------------------------------E--------------X------------------------------------------------------XXX-----------E------------------------------------------------------------------------------------------------------------------------------------------------------------------------------------[]------------------------------------------------------------------------------------------------XXX-----------------------------------------------------------------------------------XX----------[]------------------------------------------------------<>-----------------------------------------------------------------------------------B------------<>---------------------------XX--------------------------E-----------XXXX-----------<>--------------------------XX--------------------------------------------------------------------------------------------------------------------------------------------[]-----------B---------------------------------------------------------------------B----------------------------------------<>----------------
----XX-XXXXX----------------------------------------------------------------------------------------------------------------------------XX------------<>------------------------------------------------------[]--------------------------<>-------------b-------------E------------[]--------------X-------------------------<>--------------------------XX----------------------------------------<>--------------X------------------------------------------------------XXX----------<>---------------------------------------------------------------------------------------------------------------------------------------------------------X--------------------------[]-------------------------------------------------------------------------------------------------XX----------------------------------------------------------------------------------XXX----------[]------------------------------------------------------[]-----------------------------------------------------------------------------------b------------[]---------------------------XX--------------------------B----------XXXXX-----------[]-------------B------------XX------------------------------------------------------------------------------------------------------------------------------------E-------[]-----------b-------------------------------------------------------B-------------b----------------------------------------[]----------------
--------X----------------E------------------------------------E--E-------------------------------X------E----------------EE-------E-----XX------------[]------------------------------------------------E-----[]--------------------E-E---[]-------------B------------EE----E-------[]--------------X--------E-EE-------------[]--------------------------XX-------------E--------------------------[]--------------X------------------------E------------E-E--------------XXX----------[]------E-EE-E-E-------------------------------------------------------------------------------E-EE----E------E-------------E-E-----------E-E--------------X-----------------EE-E-----[]-----------------------------------------------E--E--E-------------------------------------------XX------------------------EE-E------------X--------E--E------------E---------------XXXX--E-E-----[]--------EEEE------------------------------------------[]----------------------E-EE--------------E-E---------EEE----------------------------B------E--E--[]---------------------------XX--------------------------b----------XXXXX-----E-----[]-------------b-------------X--------------E--E-E----------------------X------------E----------E-E------------E--------E-EE-E--------------------------------------------[]-----------B----------------------------------------E--------------b-------------B--------EE-E-------------E--------------[]-----------EE---
XX--XXXX------XXXXXXXXXXXXXXXXXXXXXXXXXXXXXXXXXXXXXXXXXXXXXXXXXXXXXXXXXXXXXXXXXXXXXXXXXXXXXXXXXXXXXXXXXXXXXXXXXXXXXXXXXXXXXXXX-XXXXXXXXXXXXXXXXXXXXXXXXXXXXXXXXXXXXXXXX-XXXXXXXXXXXXXXXXXXXXXXXXXXXXXXXXXXXXXXXXXXXXXXXXXXXXXXXXXXXXXXXXXXXXXXXXXXXXXXXXXXXXXXXXXXXXXXXXXXXXXXXXXXXXXXXXXXX--XXXXXXXXXXXXXXXXXXXXXXX--XXXXXXXXXXXXXXXXXXXXXXXXX-XXXXXXXXXXXXXXXXXXXXXXXXXXXXXXXXXXXXXXXXXXXXXXXXXXXXXXXX------XXXXXXXXXXXXXXXXXXXXX-XXXXXXXXXXXXXXXXXXXXXXXXXXXX-----XXXXXXXXXXXXXXXXXXXXXXXXXXXXXXXXXXXXXXXXXXXXXXXXXXXXXXXXXXXXXXXXXXXXXXXXXXXXXXXXXXXXXXXXXXXXXXXXX-XX---XXXXXXXXXXXXXXXXXXXXXXXXXXXXXXXXXXXXXXXXXXXXX-XXXXXXXXXXXXXXXXXXXXXXXXXXXXXXXXXXXXXXXXXXXXXXXXXXXXXXXXXXXXXXXXXXXXXXXXXXXXXXXXXXXXXXXXXXXXXXXXXXXXXXXXXXXXXXXXXXXXXXXXXXXXXXXXXXXXXXXXXXXX-XXXXXXXXXXXX-XXXXXXXXXXXXXX--XXXXXXXXXXXXXXXXXXXXXXXXXXXXXXXXXXXXXXXXXXXXXXXXXXXXXXXXXXXXXXXXXXXXXXXXXXXXXXXXXXXXXXXXXXXXXXXXXXXXXXXXXXXXXXXXXXXXXXXXXXXXXXXXXXXXXXXXXXXXXXXXXXXXXXX-XXXXXXXXXXXXXX----XXXXXXXXXXXXXXXXXXXXXXX-XXXXXXXXXXXXX---XXXXXXXXXXXXXXXXXXXXXXXXXXXXXXXXXXXXXXXXXXXXXXXXXXXXX-XXXXXXXXXXXXXXXXXXXXXXXXXXXX----XXXXXXXX--XXXXXXXXXXXXXXXXXXXXXXXXXXXX--XXXXXXXXXXXX---XXXXXXXXXXXXXXXXXXXXXXXXXXXX-XXXXXXXXXXXXXXXXXXXXXXXXXXXXXXXXXXXXX-XXXXXXXXXXXXXXXXXXXXXXXXXXXXXXXXXXXXXXXXXXXXXXXXXXXXXXXX----XXXXXXXXXXXXXXXXXXXXXXXXXXXXXXXXXXXXXXXXXXXXXXXXXXXXXXXXXXXXXXXXXXXXXXXXXXXXXXXX-XXXXXXXXXXXXXXXXXXXXXXXXXXXXXXXXXXXXXXXXX--XXXXXXXXXXXXXXXXXXXXXXXXXX
