-----------------------------------------------------------------------------------------------------------------------------------------------------------------------------------------------------------------------------X--------------------------------------------------------------------------------------------------------------------------------------------------------------------------------------------------------------------------------------------------------------------------------------------------------------------------------------------------------------------------------------------------------------------------------------------------------------------------------------------------------------------------------------------------------------------------------------------------------------------------------------------------------------------------------------------------------------------------------------------------------------------------------------------------------------------------------------------------------------------------------------------------------------------------------------------------------------------------------------------------------------------------------------------------------------------------------------------------------------------------------------------------------------------------------------------------------------------------
---------------------------------------------------------------------------------------------------------------------------------------------------------------------------------------------------------------------------------------------------------------------------------------------------------------------------------------------------------------------------------------------------------------------------------------------------------------------------------------------------------------------------------------------------------------------------------------------------------------------------------------------------------------------------------------------------------------------------------------------------------------------------------X-----------------------------------------------------------------------------------------------------------------------------------------------------------------------------------------------------------------------------------------------------------------------------------------------------------------------------------------------------------------------------------------------------------------------------------------------------------------------------------------------------------------------------------------------------------------X----------------------------------------------------------------------------------------------------
SSSSSSSSSSSSSS------------------------------------------------------------------------------------------------------------------------------------------------------------------------------------------------------------------------------------------------------------------------------------------------------------------------------------------------------------------------------------------------------------------------------------------------------------------------------------------------------------------------------------------------------------------------------------------------------------------------------------------------------------------------------------------------------------------------------------------------------------------------------------------------------------------------------------------------------------------------------------------------------------------------------------------------------------------------------------------------------------------------------------------------------------------------------------------------------------------------------------------------------------------------------------------------------------------------------------------------------------------------------------------------------------------------------------------------------------------------------------------------------------------------------------------
------S-------------------------------------------------------------------------------------------------------------------------------------------------------------------------------------------------------------------------------------------------------------------------------------------------------------------------------------------------------------------------------------------------------------------------------------------------------------------------------------------------------------------------------------------------------------------------------------------------------------------------------------------------------------------------------------------------------------------------------------------------------------------------------------------------------------------------------------------------------------------------------------------------------------------------------------------------------------------------------------------------------------------------------------------------------------------------------------------------------------------------------------------------------------------------------------------------------------------------------------------------------------------------------------------------------------------------------------------------------------------------------------------------------------------------------------------------
--?---S----------------------------------------------------------------------------------o-----------------------------------------------------------------------------------------------------------------------------------------------------------------------------------------------------------------------------------------------------------------------------------------------------------------------------------------------------------------------------------------------------------------------------------------------------------------------------ooo---------------------------------------------------------------------------------------------------------------------------ooo------------------------------------------------------------------------------------------------------------------------ooooooo-------------------------------------------------------------------------------------------------------------------------------------------------------------------------------------------------------------------------------------------------------------------------------------------------------------------------------------------------------------------------------------------------------------------------------------------------------------------------------------------------------------------------------------------------o------------oo-------------------------------------------------
-----S-----------------SS-SS-------------S---------------------S-----------------------------------------------S--------------------------------------S---------------------------------------------QQQ-----------QQ--------------------------QQ---------------------------SSSSS-----------------------------------------------------SE-----S-------------------------------------------------------------------------QQQ---------------------------------------------------------------------SSS---------QQ-----------------------------------------SSSS-----S---------------------------------------------QQQ---------------------------------------------------------------S-----------------------------------------------------------------------------E-----S----------------------------------------------SSSSS------------------------------------------------------------------------------------------------------------------------------------------------------------------------------------------------------------QQQ----------------------------------------SSSSS----S-------------------SSSS--------QQQ-----------------------------E------------SS------------SS-------------------------------------oo----------------------------------------------------------------------------------oo--------S----------------------------------SS----------------------------------------------------Q----------------------------------------
-------------------------------------------------------------------------------o---------------------------------------------------------------------------X--------------------------------------------------------------------------------------------------------------------------------------------------------------------------------------------------------------------------------------------------------------------------------------------------------------------------------------------------------------------------------------------------------------------------------------------------------------------------------------------------------------------------------------------------------------------------------------------------------------------------------------------------------------------------------------------------------------------------------------------------------------------------------------------------------------------------------------------------------------------------------------------------------------------------------------------------------------------------------------------------------------------------------------------------------------------------------------------------------------------------------------------------------------------------------------------------------------------------------------------------------------------------------------------
-SS---------------------------------------oo------------oo------------o---------------------------------------S---------------XX--------------------------XX------------oo------------oo-------------------------------------------------------------------------------------------------------------------------------------------------------------------------------------o----------------------------------------------------------------------------------------------------------------------------------------------------------------------------------------------------------------Xo-----------------------------------------------------------------------S------------------------------------------------------------------------------------------------------------------------------------------------------------------------------------------------------------------------------------------------------------------------------------------------------------------------------------------------------------------------------------------------------------------X--------------------------------------------------------------------------------------SS---------------------------------------------------------------------------------------------------------------------------------------------------------------------------------------------------------------------------------------------------------------------
--S-----------------------------------------------------------X--------------------------------------------------------------------------------S-----------X------------------E-------------------------------------------------------------------------------------------------------------------------XXXXX----------------E----X--S-------------XXXX---------------------------XX-------------------------------------------------------------------------------------------------------------------------------------------------------------------------------------------------------------o--------------------------------------------------------------------SSS--------------------------------------------------------X----------------------XXSS------------------------X--SS---------------------------------------------------------------------------------------------o-oo-----------------------------------------------------------------------------------------E------------------------------------------------------------X-----------------------------------------X-------------------------------------------------------X--S------------------------X--SS-------------------------------------Xooo--------------------------------------------------------------------------------X-SS-----E----------------------------------------------------------------------------------------------------------------------------------
-SSS-S-SSS----------Q?SSSSS--------QQSSSS-------------------------------E-----------------------------------XX--QQQ-----------XX---------------------------X----------------------------------------QQQ-----------QQQ-------------------------QQQ-----------Q------------------------------------E--------------------------<>-------------E------------------QQ-------E--------------------------------QQQ-----------QQQQ----------X-------------X---------------------------Q-------------XXX-----------QQQQ----------Q------------------------------------E----Q-------------Q---------------------------QQQ-------------------------Q-------------XXX---------------------------------------Q-----------------------------------------------------------------------------------XX-------------X---------------------E----------------------------------------------QQQ---------------------E-------------------------------Q-------------------------------------------------<>------------------Q-------------X-------------QQQQ----------XXX-----------X-------------X--------E----XXX-----------X--------E----QQQ-------------------------X----------------------E----XXX--------------------E------------<>------------------QQQ------E-------------E-------------------------------------------------------E--------------------------------X----------------------E----QQQ-------------------------QQQQ--------------------------------------
------------------------------E---------------------E------------------<>--------------------E-------------XXX----------------XX---------------------E----XX-----------------------------------------------------------------------------E--------------------------------X-E-------------------<>--------------------------[]----XXX-----<>--------------------------<>------------------------------------------------------------X-------------XXX-------------E------E------------------XXX----------------------------------E----X-E-----------XXX-----<>---------------------------E-----------------------------------------E------------------XXX------------X-------E--------------------------------------------------------------------------XXX------E------------------XXX-----------XX--------------E-----<>------------------X-E----------------------------------E-------------<>----------------------------------------E---------------------------E------------[]----X-E--------------------E-------------E------------------XXX-----------XXX-----------XXX-----<>----XXX-----------XXX-----<>--------------------------------X---------------E-----<>----XXX-------------------<>------------[]--------------------------<>------------<>------------------XXE---------------------------------<>--------------------------------XXX-------------E-----<>-----------------------------------------E--------------------------------
-----------------------------<>--------------------<>------------------[]-------------------<>------------XXXX----------------XX--------------------<>----XX----------------------------------------------------------------------------<>------------------oo------------X---------------------[]--------------------------[]------------[]--------------------------[]------------------------------------------------------------XXX-----------XXX-----------XXX-----<>----oo------------XXX-----<>------------------XX------<>----XXX-------------------[]--------------------------<>--------------------------------XX------<>------------------XXX-------------------------XXX-----<>----------------------------------------------oX--------------------<>------------------XXX-----------XX--------------------[]------------------XXX-----<>----Xo-----------------------------------[]---X----------------------------X------<>----XXX-----<>----XX------<>------------[]----XXX-------------------<>----X-------<>------------------XXX-----------XXX-----------X-------[]----XXX-----------XXX-----[]------------------oX------------X-------<>------X-----[]----XXX-----------XXX-----[]------------[]--------------B-----------[]----XXX-----[]----XXX-----------XXX------------B--------------------[]----XX--------------------------XXX-------------------[]------------------Xo--------------------------XX--------------------------
------------XX-EE------------[]--------------------[]------------------[]----------X-XE-EE--[]-E-E--E----XXXXX---------------EXX----------EEXX------[]-E--XX----------EE-------------------------------------------------------EXX------[]---E---------------E--E------E-EX---E--E-E--E-XXX-----[]-------------------ES-----[]-----S------[]-------------------EE-E---[]---E--------------------------------------EE-E--------------XXX------E-EEEXXX------E-EEEXXX-E---[]-E-E-XE-E----E-E-EXXX-----[]-EE---------------XX------[]---EXX--EE-E-E-EEE-S------[]--------EE-----E-EXS------[]---E----------------------------XXX-----[]---E-E--E----E-E-EXXX------E-EE---------------XXX-----[]-EEE----E------E-E-------------XXXX-----------XX-----------E-S------[]-----S-----------EXXX------E-EE-XX----------EE--------[]--------E-EE---E--XXX-E---[]-E-EXXX-E----E-E-E-------------E---------[]---XXX------E-E------E--------EXX------[]---EXXX-E---[]-E-EXXX-E---[]-E-E-EE-----[]----XX--EE-E-E-E-E-EE-EE--[]-E--XXX-----[]-E----------------XXX--------EE-XXX--------EEEXX------[]----XXX----E-E-EE-XXX-----[]-E---------------XXX-----------EXXX-----[]-EE--XX-E---[]-E--XXX------E-EE-XXX-----[]-E-E-EE-E---[]-E------------b----E------[]---EXXX-----[]-E--XX----------EEXXX-E--E-E-EEEEb-----------EXSS-----[]----XX--E--------E--------------XXX----E-E-EE--SX-----[]-E------E-----EE-E----EE-E---E-E--------------XX----------EE-------------E
XXXXXXXXXXXXXXXXXXXXXXXX-XXXXXXXXXXXXXXXXXXXXXXXXXXXXXXX--XXXXX--------XXXXXX---XXXXXXXXXXXXXXXXXXXXXXXXXXXXXX--XXXXXXX-XXXXXXXXXXXXXXXXXXXXXX-----XXXXXXXXXXXXXXXXXXXXX--XXXXX---XXXXXXXXXXXX--XXXXXXXXXXXXXXXXXXXXXXXXX--XXXXXXXXXXXXXXXXXXXXXXXXXX--XXXXXXXXXXXXXXXXXXXXXXXXXXXXXXXXXXX---XXXXXXXXX--------------XXXXXXXXXXXXXXXX----XXXXXXXX--------------XXXXXXXXXXXXXXXXXXXXX-XXXXXXX-XXXX----XXXXXXXXXXXXXXXXXXXXXXXXXX-XXXXXXXXXXXXXXXXXXXXXXXXXXXXXXXXXXXXXXXXXXXXXXXXXXXXXXXXXXXXXXX---XXXXXXXXXXXXXXXXXXXXXXXXXXXXXXXXXXXXXXXXXXXXXXXXXXXXXXXXXXXXXXXXXXXXXXXXXXXXXXXXXXXXXXXXXXXXXX-XXXXX---XXXXXXXXXXXX--XXXXXXXXXXXXXXXXXXXXXXXXXXXXXXXXXXX-XXXXXXXXXXX-------X-XXXXXXXXXXXXXXXXXXXXXXXXXXXXXXXXXXXXXXX---XXXX--------XXXXXXXXXXXXX--XXXXXX------XXXXXXXXXXXXXXXXXXXXXXX-----XXXXXXXXXXXXXXXXXXXXXXXXXXXXXXXXXXXXXXXXXXXXXXXXXXXXXXXXXXXXXXXXXXXXXXXXXXXXXXXXXXXXXXXXXXXXXXXXXXXXXXXXXX----X-XXXXXXXXXXXXXXXXXXXXXXXXXXXXXXXXXXXXXXXXXXXXXXXXXXXXXXXXXXXXXXXXXXXXXXXXXXXXXXXXXXXXXXXXXXXXXXXXXXXXXXXXXX------XXXXXXXXXXXXXX--XXXXXXXX-XXXXXXXXXXXXXXXXXXXXXXXXXX----XXXXXXXXXXXXXXXXXXXXXXXX---XXXXXXXXXXXXXXXXX-XXXXXXXXXXXX-XXXXXXX------XXXXXXXXXXXXXXXXXXXXXXX-----XXXXXXXXXXXXXXXXXXXXXXXXXXXXXXXXXXX------XXXXXXXXXXXXXXXXXXXXXXXXXXXXXXXXXXXXXXXXXXXXXXXXXXXXXXXXXXXXXXXXXXXXXXX--XXXXXX------XXXXXXXXXXXXXXXXXXXXXXX-XXXXXXXXXXXXXX-XXXXXXXXXXXXXXXXXXXXXXXXXXXXXXXXXXXXXXXXXXXXXXXXXXXXXXXXXXXXXXXXXXXXXXXXX-XXXXXXXXXXXXX--XXXXX
