---------------------------------------X----------------------------------------------------------------------------------------------------------------------------------------------------------------------------------------------------------------------------------------------------------------------------------------------------------------------------------------------------------------------------------------------------------------------------------------------------------------------------------------------------------------------------------------------------------------------------------------------------------------------------------------------------------------------------------------------------------------------------------------------------------------------------------------------------------------------------------------------------------------------------------------------------------------------------------------------------------------------------------------------------------------------------------------------------------------------------------------------------------------------------------------------------------------------------------------------------------------------------------------------------------------------------------------------------------------------------------------------------------------------------------------------------------------
------------------------------------------------------------------------------------------------------------------------------?-----------------------------------------?---------------------------------------------------------------------?-------------------------------------------------------?--------------------------------------------------------------------------------XX---------------------------------------------------------------------------------------------------------------------------------------------?-----------------------------------------------------------------------------------------------------------------------------------------------------------------------------------------------------------------------------------------------------------------------------------------------------------------------------------------------------------------------------------------------------------------------------------------------------------------------------------------------------------------------------------------------------------------------------------------------------------------------------------------------------------------------------------------------------------------------------------------------------------------------------------------------------------------------------------------------------------------------------------------------------------------
SSSSSSSSSSSSSS------------------------------------------------------------------------------------------------------------------------------------------------------------------------------------------------------------------------------------------------------------------------------------------------------------------------------------------------------------------------------------------------------------------------------------------------------------------------------------------------------------------------------------------------------------------------------------------------------------------------------------------------------------------------------------------------------------------------------------------------------------------------------------------------------------------------------------------------------------------------------------------------------------------------------------------------------------------------------------------------------------------------------------------------------------------------------------------------------------------------------------------------------------------------------------------------------------------------------------------------------------------------------------------------------------------------------------------------------------------------------------------------------------------------------------------
------S-------------------------------------------------------------------------------------------------------------------------------------------------------------------------------------------------------------------------------------------------------------------------------------------------------------------------------------------------------------------------------------------------------------------------------------------------------------------------------------------------------------------------------------------------------------------------------------------------------------------------------------------------------------------------------------------------------------------------------------------------------------------------------------------------------------------------------------------------------------------------------------------------------------------------------------------------------------------------------------------------------------------------------------------------------------------------------------------------------------------------------------------------------------------------------------------------------------------------------------------------------------------------------------------------------------------------------------------------------------------------------------------------------------------------------------------------
--?---S--------------------------------------------------------------------------------------------------------------------------------------------------------oo----------------------------------------------------------------------------------------------------------------------------------------------------------------------------------------------------------------------------------------------------------------------------------------------------------------------------------------------ooo---------------------------------------------------------------------------------------------------------------------------------------------------------------------ooo-------------------------oo------------------------------------------------------------------------------------------------oo---------------------------------------------------------------------------------------------oooooo---------------------------------------------------------------------------------------------------------------------------------------------------------------------oo----------------------------------------------------------------------------------------------------------------------------------------------------------------------o---------------------------------------------------------------------------------------------------------------------------------------o--oo------------------------------------
-----S----------------------------------------SSS-----------------------Q---------------------------------------------------------------S-----------------------------------------S---QQ------------QQQ-------------------------------------------------S------S------------------------------------------------S-------------------------------------------------------S-------------------------------------------------------S-------------------------------oo-------------SSSSS------------E-----S-----------------------------------------------------------------------------------------------------------------------E----------SSSSS----S-----SSSS--------------------------------------------------------------------------------------------oo--E-----S---QQ--------------Q-----------------------------------------------------QQQ--------------------------------------------------------SS-----------SSS-------------------------------------Q-------------------------------------------------------------------------------S--------------------------------Q------------------------------------------------------------------------S-----------------------------------------------S--------------------------------------S---------------------SSSS---------------------------------------------------------------------------------------------Q------------------------------------------SSSSS------------------------------------
-----------------------------------------------------------------------------------------------------------------------------------------------------------------------------------------------------------------------------------------------------------------------------------------------------------------------------------------------------------------------------------------------------------------------------------------------------------------------------------------------------------------------------------------------------?-------------------------------------------------------------------------------------------------------------------------------------------E------------------------------------------------------------------------------------------------------------------------------------------------------------------------------------------------------------------------------------------------------------------------------------------------------------------------------------------------------------------------------------------------------------------------------------------------------------------------------------------------------------------------------------------------------------------------------------------------------------------------------------------------------------------------------------------------------------------------------------------------------
-SS--------------------------------------------------------------------------------------------------------------------------------------------------------------------------------------------------------------------------------------------------------------------------------------------------------------------------------------------------------------------------------------------------------------------------------------------------------------------------------------------------------------------------------------------------o------------------------------------------------------------------------------------------------------------------------------------------<>------------------------------------------------------------------------------------------------------------------------------------------------------------------------------------------------------------------------------------------------------------------------------------------------------------------------------------------------------------------------------------------------------------------------------------------------------------------------------------------------------------------------------------------------------------------------------------------------------------------------------------------------------------------------------------------------------------------------------------------------------
--S-------------------------------------------------------oo------------------------------------------------------------------oooo-----E--------------------------------Xo-------E-------------------------------------------------------E----oo-------X---------------------------E------------------oooo------E-----------------------------------------------SSS------------------------------------------------------------E----------------------------------XX------------------------X-SSS-------------------------------------------------------XXXX-----------------------------------------------------------------------------------------------------------X-XX---------------------[]------------------------------------------------------XXXXX------------------------------------------------------------------------------------------------------------------------------------------------------------------------------------------------------------------------------------------------------------------------------E---------------------------E------------------------------------------------------------X----------------------------------------------------------------E-----------------------------------------------------------------------------------------------------------------------------E------------------oooo---------------------------------------------------------------------------E------------------
-SSS-S-SSS------------------------------------------E--X--------------SQS--------------------E----Q--------E--------------------------EE----------------------------------------<>----QQQ-----------QQQ------------E--------------------<>------------EE------------<>------------<>---------------------------<>-------------------------------------------------------------------------XXX-----------X---------------------<>----X------------------------------------E--------------------------------Q-------------Q-----------------------------------------Q-------------X--------------Q--------------------------XXX--------------------E-------------E--------------------------------[]------------Q-------------X-------------QQQ-------------------------QQQ-----------SQS-----------------------------------------------------QQQ-------------------------QQQ-------------------------X-------------------------------------------------------QQQ-----------XXX-----------Q---------------------------X---------------------<>----QQQ------------QQ-----<>----QQQ-----------Q-------------X----------------------E-------------E----X--------E----Q-----------------------------------<>-------------E-----------------------------------------E-----------------------------------------E----QQ--------------------<>----X---------------------------QQQ------E----QQ-------------------------------------------------E----X-------------
---------------------------------------------------<>--X------------------------------E-----<>------------<>----X---------------------XX----------------------------------------[]-XXX----------------------------<>--------------------[]----------XXXXXXXX--------[]------------[]---------------------------[]------------E---------------------------------X-------E------------------XXX-----------XXX------E-----XE-----[]----XXX---------------------------------<>----X-E--------------------E--------------------------------------XXXXXXXX-----------------------E----XXE------X---------------------------E----XXX-----------XXE-----<>-----XE-----<>--------------------------------[]---------------------E----XXX----------------------------------E----------------------------------------------------------------------------------------------------------------------------------XXX---------------------------------------XX--------------------------XXX--------------------E-------------E----XXX-------------------[]-------------E------------[]--------------------------------XXE------E------E-----<>------X-----<>------E-----<>---------------------------E------------[]------------<>--------------------E-------------E-----<>----------------------------------E-----<>-------------E------------[]----XXX---------------------E-----------<>------------------------------------------------------<>----XXE------E----
---------------------------------------------------[]--X----------B-------------------------[]------------[]----XX--------------------------XXX-----------o---------------------[]--------------------------------[>--------------------[]----------XXX-------------[]------------[]----XXX--------------------[]-----------<>----------------------------------------<>------------------XXX-----<>----XXX-----<>------------[]----XXX-----------XX--------------------[]----X---------------------<>---------------------------------XX--XX-----------------------------<>----XXX--------------------------X------<>----XXX-------------------[]----XXX-----[]--------------------------------XX--------------------<>----XXX-----<>--------------------------<>--------------------------------XX------------o-----------------------------------------XXX---------------------------------------XXX---------------------------------------XXX-------------------------XXX------------S------<>------------<>----XXX-------------------[]--------------------------[]------------------o-------------XXX-----<>------------[]----XXX-----[]----XXX-----[]--------------------------<>------------[]------------[]----o---------------------------XXX-----[]------------------XX------<>----XXX-----[]------------<>------------[]----XXX--------------------<>-----------[]-------------------X----------------------------------[]----XXX-----<>----
------------XX----EE-EE----------------------------[]--X----------b----E-----------E-SX-----[]-E---EE-EE--[]-E-EXX--EE-E-----E--------------XX--EE-E---E-E----EE-E---E-E--------[]--------------------------------[]-----------E-SS-----[]----------X--------EE-E---[]-E---SS-----[]-E--XXX------E-EEE---------[]---XX------[]--------E------E-EXX----------EE--------[]----XX------------XXX-----[]-EE-XXX-----[]-EE--SS-----[]----XXX--------EEEXXX------E-E-EXS------[]----X---E--E-E--E-XXX-----[]-E------E------E-E-E-----------E----------------X------------EE-E---[]-E-EXXX--------EEE-------------E-XX-E---[]-E-EXXX------E-EE--S------[]----XXX-----[]-E--------------------EE-E---E-EXX----------EE--E-EE--[]-E-EXXX-----[]-EE-----E--------EXS------[]-------------------E---------E-EXXX------E-EEE----EE-----E-E---------------------------EXXX-E--E-E-E-E----E--------EXX-----------EXXX----E-E-EE-----E--E---E---S-------E---EXXX---------EE-------------EXXX----E---EE--XE-E---[]---EXX------[]---EXXX------E-EEE-SS-----[]-----E--E----E-E-E--------[]-------------------E--EE---E-E-EXXX-----[]-EEE-SX-----[]-E--XXX-----[]----XXX-----[]-E---E-----------EXX------[]---EXSS-----[]----XXX-----[]-E------E--------E--S-----------XXX-E---[]-E----E-E----E-E--XXX-E---[]-E-EXXX-----[]-E---E------[]---E-E------[]----XXX------E-EEE---------[]-----------[]-----------------EXX-----------E--E-E--E--EE--XSX-----[]----XXX-----[]-E--
XXXXXXXXXXXXXXXXXXXXXXXXXXXXXXXXXXX--XXXXXXXXXXXXXXXXXXXXXXXXXXXXXXXXXXXXXXXX--XXXXXXXXXXXXXXXXXXXXXXXXXXXXXXXXXXXXXXXXXXXXXXXXXXXXXXXXXXXXXXXXXXXXXXXXXXXXXXXXXXXXXXXXX-XXXXXXXXX--XXXXXXXXXXXXXXXXXXXXXXXXXXXXXXXXXXXXX--XXXXXXXXXXXXXXXXXXXXXXXXXXXXX--XXXXXXXXXXXXXXXXXXXXXXXXXXXXXXXXXXXXXXXXXXXXXXXXXXXXXXXXXX-------XXXXXXXXXXXXXXXXXXXXX--XXXXX-XXXXXXX------XXXXXXX----XXX-XXXXXXXX---XXXXXXXXXXX---XXXXXXXXXXXXXXXXXXXXXXXXXXXXXXXXXXXXXXXXXXXXXXXXXXX-------XXXXXXXXX-XXXXXXXXXXXX-------XXXXXXXXXXXXXXXXXXXXXXXXXXX-XXXXXX------------------XX--------XXXXXXXXXXXXXXXXXXXXXXXXXXXXXXXXXXX--XXXXXXXXXXXXXXXXXXXXXX-XXXXXXXXXXXX-XXXXXXXXXXXXXXXXXXXXXXXXX----------XXXXXXXXXXXXXXXXXXXXXXXXXXXXXXXXXXXXXXXXXXXXXXXX--XXXXXXXXXXXXXXXXX-XXXXXX-------XXXXXXXXXXXXXXXXXXXXXXXXXXXXXXXXXXXX---XXXXXXXXXXXXXXXXXXXXXXXXXXXXXXX-XXXXXXXXXXXXXXXXXXXXXXXXXXXXXXXXXXXXXXXXXXXXXXXXXXXXXX--XXXXXXXXXXXXXXXXXXXXXXXXXXXXXXXXXXXXXXXXX-XXXXXXXXXXXXXXXXXXXXXXXXXXXXXXXXXXXXXXXXXXXXXXXXXXXXXXXXXXXXXXXX---XXXXXXXXXXXXXXXXXXXXXXXXXXXXXXXXXXXXXXXXXXXXXXXXXXXXXXXXXXXXXXXXXXXXXXXXXXXXXXXXXXXXXXXXXXXXXXXXXXXXXXXXXXXXXXXXXXXXXXXXXXX---XXXXXXXXXXXXXXXXXXXXXXXXXXXXXX-XXXXXXXXXXXXXXXXXXXXXX-X-XXXXXXXXXX-----XXXXXXXXXXXXXXXXXXXXXXXXXXXXX---XXXXXXXXXXXXXXXXXXXXXXXXXXXXXXXXXXXXXXXXXXXXXXXXXXXXXXXXXXXXXXXXXXXXXXXXXXXXXXXXXXXXXXXXXXXXXXXXXXXXXXXXXXXXXXXXXXXXXXXXXXXXXXXXXXXXXXXXX-XXXXXXXXXXXXX--XXXXXXXXXXXXXXXXXXXXX---XXXXXXXXXXXXXXXXXXXXXXX
