--------------------------------------------------------------------------------------------------------------------------------------------------------------------------------------------------------------------------------------------------------------------------------------------------------------------------------------------------------------------------------------------------------------------------------------------------------------------------------------------------------------------------------------------------------------------------------------------------------------------------------------------------------------------------------------------------------------------------------------------------------------------------------------------------------------------------------------------------------------------------------------------------------------------------------------------------------------------------------------------------------------------------------------------------------------------------------------------------------------------------------------------------------------------------------------------------------------------------------------------------------------------------------------------------------------------------------------------------------------------------------------------------------------------------------------------------------
-------------------------------------------------------------------------------------------------------------------------------------------------------------------------------------------------------------------------------------------------------------------------------------------------------------------------------------------------------------------------------------------------------------------------------------------------------------X-----------------------------------------------------------------------------------------------------------------------------------------------------------------------------------------------------------------------------------------------------------------------------------------------------X---------------------------X--------------------------------------------------------------------------------------------------------------------------------------------------------------------------------------------------------------------------------------------------------------------------------------------------------------------------------------------------------------------------------------------------------------------------------------------------------------------------------------------------------------------------------------------------------------------------------------------------------------------------------------------------------
SSSSSSSSSSSSSS------------------------------------------------------------------------------------------------------------------------------------------------------------------------------------------------------------------------------------------------------------------------------------------------------------------------------------------------------------------------------------------------------------------------------------------------------------------------------------------------------------------------------------------------------------------------------------------------------------------------------------------------------------------------------------------------------------------------------------------------------------------------------------------------------------------------------------------------------------------------------------------------------------------------------------------------------------------------------------------------------------------------------------------------------------------------------------------------------------------------------------------------------------------------------------------------------------------------------------------------------------------------------------------------------------------------------------------------------------------------------------------------------------------------------------------
------S-------------------------------------------------------------------------------------------------------------------------------------------------------------------------------------------------------------------------------------------------------------------------------------------------------------------------------------------------------------------------------------------------------------------------------------------------------------------------------------------------------------------------------------------------------------------------------------------------------------------------------------------------------------------------------------------------------------------------------------------------------------------------------------------------------------------------------------------------------------------------------------------------------------------------------------------------------------------------------------------------------------------------------------------------------------------------------------------------------------------------------------------------------------------------------------------------------------------------------------------------------------------------------------------------------------------------------------------------------------------------------------------------------------------------------------------------
--?---S--------------------------------------------------------------------------------------------------------------------------------------------------------------------------------------------------------------------------------------------o-------------------------------------------------------------------------------------------------o-----------------------------------------------------------------------------------------------------------------------------------------------------------------------------------------------------------------ooo-------------------------ooo-------------------------------------------------------------------------------------------------------------------------------------------------------------------------------------------------------------------------------------------oo-----------------------------------------------------oo-------------------------------------------------------o-----------------------------------------------------------------------------------------------------------------------------------------------------------------------oo----------------------------------------------------------------------------------o-------------------------------------oo-----------------------------------------------------------------------------------------------------------------------------------------------------------------------------------
-----S------------------------------------QQQ-----------------------------------------------------------------------------------------------------------------------------Q------------------------------------------------------o-------------SSSSS-----------------------------S---------?------SSSS----------------------------QQ---------------SS-------------------------SSSS----------------------oo----------------------------------------oo----------------------------------------QQ--------------------------QQ------------QQ----------------------------------------QQ---------------------------o--------S-----------------------------------------S-----------------QQ----------------------------------?-----------------------E-----S---oo--------------Q--------------------------------------------------------------------------------------------------------------SSSS----------SSSSS--------------------------------------------------------------------------S------------------Q--------------QS----------oo--------S-------------------------------oo--------S---------------------------------SSS--------------------------S--------------------------SSS---------QQ---------------------------------------------------------------------SSS--------------------------------------QQQSQ-----------------------QQ------------------------------------------------------oQ------------oQ----------------------------------------
-----------------------------------------------------------------------------------------------------------------------------------------------------------------------------------------------------------------------------------------------------------------------------------------------------------------------------------------------------------------------------------------------------------------------------------------------------------------------------------------------------------------------------------------------------------------------------------------------------------------------------------------------------------------------------------------------------------------------o-----------------------------------------------------------------------------------------------------------------------------------------------------------------------------------------------------------------------------------------------------------------------------------------------------------------------------------------------------------------------------------------------------------------------------------------------------------------------------------------------------------------------------------------------------------------------------------------------------------------------------------------------------------------------------------------------------XX-------------------------
-SS--------------------XXX--Xo------------------------------------------------------------------------------------------------------------------------------------------------------------------------------------------------------------------------------------------------------------------------o-------------------------------------------------------------------------------------------------------------------------------o----------------------------------------------------------------------------------------------------------------------------------------------------------------------------------------------------------------------------------------------------------o------------Xoo----------------------------S--------------------------------------------------------------------------------------------------------------------------XXX--------------SS----------------------------------------------------------------------------------------------oo---------------------------------------------------------------------------------------------------------------------------------------------------------------------------------------------------------------oo----------------------------------------------------------------------------------------------------------------------------------------------------------------------------------------------------------------XX------------ooo-----------
--S-------------------------------E-----------------------oo-XX--------------------------------E--------EXX----------------------------E-------------------------------------------------o--------------------------------------oooo------E--------------------------------------------------------E------------------------------------------------------------------------------------------------------XX-------------------E--------------------oo---------------------------------------------------------------------------------------------------------------------------------------------------------------E--------------------------------X-SS-------------------------------------------X------------------------------------XXSSS---------oooo--------------------------oo------------------------X-XXXX--------------------------------------------------XX---------------S-----------------------------------------------------------------------------------------E----------------------------------------------X-XX--------------------------------------X-SS-----E-----------------------------------------------------------------------------------------------------------------------------------------------------------------------------------------------------------------E--------------------------------------------------------------------------------------------------------------------XX--------------------------
-SSS-S-SSS--------------------------------SQSQ----------------------------------E----E------S?S---------------------------------------<>----QQ--------------------------QQS----------------------------------E-------------E-------------<>-----------------QQ--------------------Q---------------S-----------------QQQ--------------------------------------------------------------E-------------E--------------------------<>--------------------------------SSS-------------------------QQQ--------------------E----QQQ-----------QQQ-----------QQQ-------------------------QQQ-----------Q---------------------<>------------------QQQ--------------------E------------------QQQ-----------------------------------------------------X---------------------------QQS--------------------------------------------------------------E--------------------------------XXX-----------XX------------------------------------------------------QQQ---------------------------------<>------------------QQQQ----------SSS--------------------E-------------E--------------------------<>----Q--------E------------------X-----------------------------------------X----------------------E----QQQ------------------------------------------------------Q------------------------------------------------<>----QQQQQ-----------------------QQ--------------------------Q--------E---------------------------E------------------XX--------------------------
-------------------------------------------------------------------------------<>---<>------------------------------------------------[]-E-----------E-------------E----------------------------------E-----<>------------<>-------------[]---------------------------------------------------------------------B----------------------------------------E-------------E------E-----<>------------<>-------------E------------[]---------------------------------------------------------------------E-----XE-----<>---------------------------------------------------------------------E--------------------------[]---------------------------E------------<>------------------------------------------------------------X-------------XXX------E-------------------------------------------------------E--------------------E-----<>--------------------------------XXX-----------XXX-----------------------------------------E------E-------------E--------------------------[]----------------------------E-------------------------<>------------<>--------------------------[]------------<>------E-----------XXX-------------------------X-------------XXX-------------E-----<>-------------E--------------------------------X-E------------------------------------------------E------------[]-----------------------------------------E----X---------------------<>--------------------------<>-------------E----XX--------------------------
--------------------------------------B----------------------------------------[]---[]------------------------------------------------[]<>----------<>------------<>--------------------------------XXX-----[]------------[]-------------[]---------------------------------------------------------------------b---------------------------------------<>----XX------<>----XXX-----[]----XXX-----[]------------<>------------[]-----X----------------------------------------XX--------------------<>----XXX-----[]------------------------------------------------------------------------------------------------[]----XXX-------------------<>------------[]------------------------------------------------------------XX------------X-------<>------------------------------------------B---XX------<>------------------XXX-----[]----o---------------------------XXX-----------X-X-----------X-------------oo------------XXX-----<>------------<>----Xo--------------------[]---------------------------<>-------------------------[]-----XX-----[]----XX--------------------[]------------[]----XXX-----<>----XXX-----------Xo------------XX------------XXX-----<>------X-----[]------------<>------------------Xo------------XXX---------------------------------------XX------<>------------[]------------------oo--------------------<>----XXX-------------------[]----XX--------------------[]------------<>----XXX-------------------------
------------XX-------------X----------b----------------------------------------[]---[]-----------E---------------------------E--E-----[][]---E------[]---E-S------[]-----E-----------EXS------------XXX-----[]-E---SS-----[]-------------[]-----E-E--E-E-E---E--E----E---E-EE------------E-E---------X----------B-------EE-----E-E---------------EE-EE--[]-E--XXX-E---[]-E-EXXX-E---[]-E--XXX-E---[]-E-E-S------[]------E-----[]----XX----------EE---------------E--E--------EXXX------E--EE--------[]----XXX-----[]-E---------------E-------------E-E-----------E----E------E-E------------------EE-----E-E-S------[]----XXX------E--EE-EE-EE--[]-E-EXSX-----[]----XX-----------E-----------------------------------------XX---EE-E-----EXX------[]-E-----------------E-----------E----------b---XXX-----[]---EXX------------XXX-E---[]-E-E----EE-----E-E-E-----------EXXX---------EEXX-------E--E-X---E--E-------X--E------E-EXXX-----[]-E-E-E------[]---EX---E--E-----E-SS-----[]-----------------X---------[]----E-EE-----EE-E-S------[]----XXX-E---[]-E--XXX------E---E-S------[]-----E------[]----XXX-----[]-EEEXXX-E--E-E-EE-----EE-E-E-E-EX---EE-E----E-XXX-----[]-EEE-XX-E---[]-E----------[]------------------X---EE-E---E-EXXX-EE-E-E-E-E-------------E----E--E--E---XX------[]---E--E-----[]-------------------E--E--------E--------[]----XX--EE-E----EE-E------[]----XX----------EE-S------[]-----S------[]----XX----------EE--------------
XXXXXXXXXXXXXXXXXXXXXXXXXXXXX-XXXXX---XXXXXXXXXXXX-XXXXX--XXXX--------XXXXXXXXXXXXXXXXXXXXXXXXXXXXXXXXX-----XXXXXXXXXXX--XXXXXXXXXXXXXXXXXXXXXXXXXXXXXXXXXXXXXXXXXXXXXXXXXXXXXX--XXXXXX----XXXXXXXXXXXXXXXXXXXXXXXXXXXXXXXXXXXXXXXXXXXXXXXXXXXXXXXXXXXXXXXXXXXXXXXXXXXXXXXXXXXXXXXX--XXXXXXXXXXXX--XXXXXXXXXXXXXXXXXXXXXXXXXXXXXXXXXXXXXX--XXXXXXXXXXXXXXXXXXXXXXXXXXXXXXXXXXXXXXXXXXXXXXXXXXXXXXXXXXXXXX-----XXXXXXXXXXXXXXXXXXXXXX-XXXXXX--XXXXXX---XXXXXXXXXXXXXXXXXX-XXXXXXXXXXXXXXXXXXXXXXXXXXXXXXXXXXXXXXXXXXXXXXXXXXXXXX--XXXXXXXXXXXX--XXXXXXXXXXXX-XXXXXXXXXXXXXXXXXXXXXXXXXXXXXXXXXXXXXXXXXXXXXXXXXXXXXXXXXXXXXXXXXXXXXXXXXXXXXXXXXXXXXXXXXXX------XXXXXXXXXXXXX---XXXXXXXXXXXXXXXXXXX--XXXXX-----XX--XXXXXXXXXXXXXXXXXXXXXXXXXXXX-----XXXXXXXXX-XXXXXXXXXXXXXXXXXX--XXXXXXXXXXXXXXXXXXXXXXXXXXXXXXXXX--------------XXXXXXXXXXXXXXXXXXXXXXXXXXXXXXXXXXX--XXXXXXXXXXXXXXXXXXXXX----XXXXXXXXXXXXXXXXXXXXXXXXXXXXXXXXXXXXXXXXXXXXXXXXXXXXXXXXXXXXXXXXXXXXXXXXXXXXXXXXXXXXXXXXXXXXXXXXXXX---XXXXXXXXXXXXXXXXXXXXXXXXXXXXXXXX------XXXXXXXXXXXXXXXXXXXXXXXX--XXXXXXXXXX------XXXXXXXXXXXXXXXXXXXXXXXXXXXXXXXXXXXXXXXXXXXXXXXXXXXXXXXXXXXXXXXXXXXXXXXXXXXXXXXX--XXXXXXXXXXXXXXXXXXXXXXXXXXXXXXXXXXXXXXXXXXXXXX--XXXXXXXXXXXXXXXXXXXXXXXXXXXXXXXXXXXXXXX--XXXXXXXXXXXXXXXXXXXXXXXXXX-XXXXXXXXXXXXXXXXXXXXXXXXXXXXXXXXXXXXXXXXX-XXXXXXXXXXXXXXXXXXXXXXXXXXXXXXXXXXXXXXXXXXXXXXXXXXXXXX---XXXXXXX---XXXXXXXXXXX-XXXXXXXXXXXXXXXXXXXXXXXXXXXXXXXXX--XXXX
