--------------------------------------------------------------------------------------------------------------------------------------------------------------------------------------------------------------------------------------------------------------------------------------------------------------------------------------------------------------------------------------------------------------------------------------------------------------------------------------------------------------------------------------------------------------------------------------------------------------------------------------------------------------------------------------------------------------------------------------------------------------------------------------------------------------------------------------------------------------------------------------------------------------------------------------------------------------------------------------------------------------------------------------------------------------------------------------------------------------------------------------------------------------------------------------------------------------------------------------------------------------------------------------------------------------------------------------------------------------------------------------------------------------------------------------------------------
------------------------------------------------------------------------------------------------------------------------------------------------------------------------------------------------------------------------------------------------------------------------------------------------------?--------------------------------------------------------------------------------------------------------------------------------------------------------------------------------------------------------------------------------------------------------------------------------------------------------------------------------------------X--------------------------------------------------------------------------------------------------------------------------------------------------------------------------------------------------------------------------------------------------------------------------------------------------------------------------------------------------------------------------------------------------------------------------------------------------------------------------------------------------------------------------------------------------------------------?-----------------------------------------------------------------------------------------------------------------------------------------------------------------------------------------------------------------?-------------
SSSSSSSSSSSSSS------------------------------------------------------------------------------------------------------------------------------------------------------------------------------------------------------------------------------------------------------------------------------------------------------------------------------------------------------------------------------------------------------------------------------------------------------------------------------------------------------------------------------------------------------------------------------------------------------------------------------------------------------------------------------------------------------------------------------------------------------------------------------------------------------------------------------------------------------------------------------------------------------------------------------------------------------------------------------------------------------------------------------------------------------------------------------------------------------------------------------------------------------------------------------------------------------------------------------------------------------------------------------------------------------------------------------------------------------------------------------------------------------------------------------------------
------S-------------------------------------------------------------------------------------------------------------------------------------------------------------------------------------------------------------------------------------------------------------------------------------------------------------------------------------------------------------------------------------------------------------------------------------------------------------------------------------------------------------------------------------------------------------------------------------------------------------------------------------------------------------------------------------------------------------------------------------------------------------------------------------------------------------------------------------------------------------------------------------------------------------------------------------------------------------------------------------------------------------------------------------------------------------------------------------------------------------------------------------------------------------------------------------------------------------------------------------------------------------------------------------------------------------------------------------------------------------------------------------------------------------------------------------------------
--?---S------------------------------------------------------------------------------------------------------------------------------------------------------------------------------------------------------------------------------------------------------------------------------------------------------------------------------------------------------------------------------------------------------------------------------------------------------------------------------------------oo--------------------------------------------------------------------------------------------------------------------------------------------------------------------------------------------------------------------------------------------------------------------------------------------------------------------------------------------------------------------------------------------------------------------------------------------------------------oo--------------------------------------------------------------------------------------------------------------ooo-------------------------------------------------------------------------------------------------------------------------------------------------------o---------------------------------------------------------------------ooo------------------------------------------------------------------------------------------------------------------------------------
-----S--------------------------------------------------------------------S-------------------------------------------------------------------------------QQ---------------Xo-----------------------------------------------------------------------------------------S-------------------------------oo--------S-------o-------------------S---------------------------------------------Q-------------------------------------------------------------------------------------------------------------------E-----S-------E------------------------SSSSS-----------SS-------------------S-----------------------------------------------------------QQQ-------------Q----------------------------------------------------------------------------------------------------------------------------------------------------------SS------------------------------------------------------------------SSSSS------------------------------------oo----------------------------------------------------------------------------------------------------------------------------------------------------------SSS------------------------------------------------------------------SSSSS----------SSSS------------------S---oo--------S---------------------------------------------Q-Q-------------------------------------------------S---------------------E---------QQ---------------------------------------S----------------------------oo--------S---
---------------------------------------------------------------------------------------------X----------------------------------------------------------------------------------------------------------------------------------------------------------------------------------------------------------------------------------------------------------------------------------------------------------------------------------------------------------------------------------------------------------------------------------------------------------------------------------------------------------------------------------------------------------------------------------------------------------------------------------------------------------------------------------------------------------------------------------------------------------------------------------------------------------------------------------------------------------------------------------------------------------------------------------------------------------------------------------------------------------------------------------------------------------------------------------------------------------------------------------------------------------------------------------------------------------------------------------------------------------------------------------------------------------------------------------------------------------
-SS-------------------------ooo-----------oo-------------------------------------------o-----------E-------------------------------------------------------------------------------------------------------------------------------------------------------------------------------------------------------------------------------------------------------------------------------------------------------------------------------------------------------------------------------------------------------------------------------------------------------------------------------------------o----------------------------------------------------------------------------------------------------------------------------------------------------------------------------------------------------------------------------------------------------------------------------------------------------------------------------------------------------------------------------------------ooo-------------------------------------------------------------------------------------------------------------------------------------------------------------------------------------------------------------------------------------------------------------------------------------------------------------------------------------------------------------------------------------------------------------------------------------------------------------
--S------------------E----------------------------------oo-----------------------------XX-------------XXX---------o-------E-------------------------------------------------XXX--------------------------------------------------------------------------------------E--------------------------------XXXX-----E------XXXX---o-------------E---------------------------------------------------------------------------------------------------------------E----------------------------------------------XXSSS---------X-SSS---------------------------------------------------XX-------E-------XXXX--------------------------------------X-----------------------------------------------------------------------------------------E-------X-----------------------------------------------------------------------------------------E-----------------------------------------E--------------------------------------------------------------oo---------------------------------------------------------------------------------------------------------------------E-------------------------------------------------------------------------------------------------------------------------------------------E----XXSS-----E--------------------oo------------------------------------------------------------------X-SS------------------------XX----------------------------------------------------------------------------------XXXXXX--------
-SSS-S-SSS----------<>---S?--------------------------------------E-------------E-----------------------------------------<>---Q-------------QQ------------QQQ-------------------------QQ------------QQQ-----------QQQ-----------X-----------------------------------<>----QQQ------E----X---------------------<>--------------------------<>-------------E--------------------------------QQ-------E----X---------------------------Q--------E------------<>------------------QQ--------------------------------------------------------------------X----------------------E------------<>------------------QQQ-----------QQQ-------------------------QQQQ----------QQS--------------------E----XXX---------------------------------<>------------------QQ------------X----------------------E----------------------------------------<>------------------X-X-------------------<>------------------X-------------Q-----------------------------------------Q-------------QQQ------E------------------QQ---------------------E-----Q------------QQ--------------------<>------------------X--------E-------------E----QQ------------QQQ------------Q--------------------------X-----------------------------------<>------------<>------------------------------------------E---SQS------------------------------------------------E----X-------------XXX-----------QQQQ-------------------------QQQQ-----X---------------------------------------------
--------------------[]------------------------------B----------XXXXXXX--E-----<>----XXX-XX-------------------------------[]------------E---------------------------E---------------------------E-------------E------------------XXX-----------X---------------------[]------------<>----XXX-------------------[]--------------------------[]------------<>------------------XX--------------------<>------X---------------------------------<>------------[]-------------E-------------E------------------XX-------E------------------XXE-----------X-E-----------XXE-----<>------------[]-EX----------------------------------------------------E----------------------------------E-----<>----XXX---------------------------------[]---------------------------E-------------E------E-----<>----X-------------X-E-------------------[]-------------E----XXX-------------------[]------------------XXE--------------------E-------------E---------------------------E------------<>----------------------------------E-----<>----------------------------------------[]------------------XXE-----<>------E-----<>-------------E----------------------------------------------XXE-------------E------E-----X------[]------------[]-----------------------------------------<>--------------------------E--------------------------<>----XXE-----------XXX-----------------------------------------------------------------------------------------XE-?--
----------------B---[]------------------------------b---------X-------XXX-----[]-----------------------------------------[]-----------<>------------------------------------------------------<>------------<>------------------XXX-----------XXX-------------------[]------------[]----XXX-------------------[]--------------------------[]------------[]----oo------------XXX-------------------[]----XXX-----------Xo------<>------------[]------------[]----XX------<>----------------------------------------<>------------------XXX-----<>----XXX-----<>----XXX-----[]------------[]------------------------------------------------------<>--------------------------------XXX-----[]----XXX-----------XX--------------------[]--------------------------<>----XX------<>----XXX-----[]----XXX-----------XXX-------------------[]----X-------<>----XXX-------------------[]------------------XXX-----<>-----X------<>------------<>--------------B---oo------<>------------[]----------------------------------------[]----------------------------------------[]------------------XXX-----[]----X-X-----[]------------<>----------------------------------------------XX------------XXX-----<>------------[]------------[]----o-----------------------B------------[]-------------------------<>--------------------------[]----XXX-----------XXX-------------------------------------------------------------------XX--------------------------
------------XX--b---[]-------------------X----------B--------XXX------XXX-----[]-E------------------X--------------------[]----E------[]---E----E------E-E-------------E-XXXX----------E------[]---E-E--EE--[]-E-E----E--------EXXX------E-EEEXX--E--E----EE-S------[]------------[]----XXX------E-EE---------[]----XX-------------S------[]----XXX-----[]---EXX-------E---EXX----------EE--------[]----XXX------E-EEEXXX-E---[]-E-E-EE-EE--[]-E-E-SS-----[]----XXX-E---[]-E-E-E--E----E---E----E------E-EXXX-----[]-E--XXX------E-E--XXX-E---[]-E-EXXX-E---[]-EE-XXX-----[]-E----------[]-------------------E-----------E----E--------EXS------[]-------------------------------EXXX-----[]-E--XXX------E-EE-XX--E--E-----E-EE-EE--[]-E--XS-------E-----E------[]---EXXX-----[]---EXXX-----[]-E-EXXX---------EEXXX-E--E-E-E-E-EE-E---[]-E--XXX-----[]----XXX----E-E-EE---------[]----XX-----------EXXX-E---[]-EE-XXX-----[]---E--------[]--------------b----XE-EE--[]-E-E-EE-E---[]----------------------E--------E-SE-----[]-E---------------E-------------E--------[]--------E--------EXXX-----[]-E--XXX-E---[]-E---E------[]---E----E--------E-------------E-------------EX---E--E-E--E-XXX-E---[]-E---S------[]-----S------[]--------E--------E----------b------------[]----------------EXX------[]---E----E------E-EXXX-----[]-E--XXX------E-EEEXXX--------EE---------------XX-----------E-----E-E--X----E-----------XXX--E------E-E--------------
XXXXXXXXXXXXXXXXXXXXXXXX-XXX-XXXXXX---XXXXXXXXXXX---XXXX-XXXXXXX------XXXXXXXXXXXXXXXXX-------XXXX--------------XXXXXXXXXXXXXXXXXXXXXXXXXXXXXXXXXXXXXXXXXXXXXXXXXXXXXXXX--------------XXXXXXXXXXXXXXXXXXXXXXXXXXXXXXXXXXX-XXXXXXXXXXXXXXXXXXXXXXXXXXXXXXXXXXXXXXXXXXXXXXXXXXXXXXXXXXXXXXXXX-XXXXXXXXXXXXXXXXXXXXXXXX---------------XXXXXXXXXXXXXXXXXXXXXXXXXXXXXXXXXX-XXXXXXXXXXXXXXXXXXXXXXXXXXXXXXXXXXXXX-XXXXXXXXXXXXXXXXXXXXXXXXXXXXXXXXXXXXXXXXXXXXXXXXXXXXXXXXXXXXXXXXXXXXXXXXXXXXXXXXXXXXXXXXXXXXXXX------XXXXXXXX-------XXXXXXXXXXXXXXXXXXXXXXXXXXXXXXXXXXXX---XXXXXXXXX-XXXXXXXXXXXXX-----------XXXXXXXXXX-XXXXXXXXXXXXX--XXXXX------XXXXXXXXXXXXXXXX-XXXXXXXXXXXX---XXXXXXXXXXXXXXXXXXXXX-XXXXXXXXXXXXXXXXXXXXXXXXXXXXXXXXXXXXXXX----XXXXXXXXXXXXXXXXXXXXXXXXXXXXXXXXXXXXXXXXXXXXXXXXXXXXXXXXXXXXXXXXXXXXXXXXXXXXXXXXXXXXXXXXXXXXXXX--XXXXXXXXXXXXXXXXXXXXXXXXXXXXXXXXXXXXXXXXXXXXX-XXXXXXXXXXXXXXXXXXXXXXXXXXXXXXXXXXXXXXXXXXXXXXXXXXXXXXXXXXXXXXXXXXXXXXXXXXXXXXXXXXXXXXXXXXXXXXXXX---XXXXXXXXXXX--XXXXXXXXXXXXXXXXXXXXXXXXXX--XXXXXXXXXXXX-XXXXXXXXXXXXXXXXXXXXXXXXXXXXXXXXXXXXXXXXXXXXXXXXXXXXXXXXXXXXXXXXXXXXX-XXXXXXXXXXXXXXXXXXXXXXXXXXX--XXXXXXXXXXXX--XXXXXXX--XXXXXXXXXXXXXXXXXXXXXXXX-XXXXXXXXXXXXX-X-XXXXXXXXXXXXXXXXXXXXXXXXXXXXXXXXXXXXXXXXXXXXXXXXXXXXXXXXXXXX--XXXXXXX-XXXXXXXXXXXXXXXXXXXXXXXXXX------XXXXXXXXXXXXXXXXXXXXXXXX-----XXXXXXXXXXXXXXXXXXXXXXXXXX--XXXXXXXXXXXXXXXXXXXXXXXXXXX---XXXXXXXXXXXXXXXXXX--------------
